Catholic	ኮተሊኽ	kotəlix	adj
Catholicism	ኩትልኽና	kutɨlɨxɨna	noun
English	እንግሊዘኛ	ʔɨnɨɡɨlizəɲa	noun
English	እንግሊዛዊ	ʔɨnɨɡɨlizawi	adj
I	ኣነ	ʔanə	pron
Italian parsley	ፐርሰሜሎ	pərɨsəmelo	noun
Jesus Christ	የሱስ ክርስቶስ	jəsusɨ kɨrɨsɨtos	noun
Laundromat	ቤተ ሕጽቦ	betə ħɨt͡sʼɨbo	noun
May	ጉንበት	ɡunɨbət	noun
Member	ወኪል ህዝቢ	wəkilɨ hɨzɨbi	noun
Pen	ጲሮ	pʼiro	noun
Pentecost	ጰንጣይ	pʼənɨtʼaj	noun
Protestantism	ከኒሻነት	kəniʃanət	noun
Wednesday	ሮቡዕ	robuʕ	noun
a little	ውሕድ	wɨħɨd	adv
a long time	ነዊሕ ግዜ	nəwiħɨ ɡɨze	adv
abandonment	ርጥረጣ	rɨtʼɨrətʼa	noun
able	ክእለታዊ	kɨʔɨlətawi	adj
abode	ጽንሒት	t͡sʼɨnɨħit	noun
abounding	ኣኺሉ ዝተርፍ	ʔaxilu zɨtərɨf	adj
absent	ቦኾረ	boxorə	verb
abundance	እኹል ተረፍ	ʔɨxulɨ tərəf	noun
abuse	ጸረፈ	t͡sʼərəfə	verb
abusive	በደላዊ	bədəlawi	adj
abusively	ብድላ	bɨdɨla	adj
accent	ኣገባብ ኣዘራርባ	ʔaɡəbabɨ ʔazərarɨba	noun
accept	ህራይ በላ	hɨrajɨ bəla	verb
accidental	ሓደጋዊ	ħadəɡawi	adj
accidentally	ብሓደጋ	bɨħadəɡa	adv
acclamation	ውዕውዕ ደገፍታ	wɨʕɨwɨʕɨ dəɡəfɨta	noun
account	ዛንታ	zanɨta	noun
accuracy	ቑኑዕ	qʰunuʕ	noun
accurate	ልክዓዊ	lɨkɨʕawi	adj
accurate	ሓቓዊ	ħaqʰawi	adj
accurate	ቕንዓዊ	qʰɨnɨʕawi	adj
accusation	ወከሰ	wəkəsə	noun
accuser	ከሰስቲ	kəsəsɨti	noun
accuser	ወከስቲ	wəkəsɨti	noun
achy	ቓንዛዊ	qʰanɨzawi	adj
acorn	ፍረ ኦክ	fɨrə ʔok	noun
acquit	ቕንዕና	qʰɨnɨʕɨna	verb
acquittal	ቑኑዕ	qʰunuʕ	noun
acquittal	ዘይበደለኛ	zəjɨbədələɲa	noun
act	ምትውሳእ	mɨtɨwɨsaʔ	verb
actor	ተዋሳአይ	təwasaʔəj	noun
actors	ተዋሰእቲ	təwasəʔɨti	noun
actress	ተዋሳኢት	təwasaʔit	noun
actresses	ተዋሰእቲ	təwasəʔɨti	noun
adjust	ምቑጽጻር	mɨqʰut͡sʼɨt͡sʼar	verb
administer	ኣምሓደረ	ʔamɨħadərə	verb
administrator	አማሓዳሪት	ʔəmaħadarit	noun
administrators	አማሓደርቲ	ʔəmaħadərɨti	noun
admiration	ኣድንቖት	ʔadɨnɨqʰot	noun
adorable	ምጩውቲ	mɨt͡ʃʼuwɨti	adj
adorable	ምጩይ	mɨt͡ʃʼuj	adj
adorable	ኣደናቒት	ʔadənaqʰit	adj
adore	ምድናቕ	mɨdɨnaqʰ	verb
advance	ቐሌጠፈ	qʰəletʼəfə	verb
advocate	ሐገዝ	ħəɡəz	noun
advocate	ምሕጋዝ	mɨħɨɡaz	verb
advocate	ምውካል	mɨwɨkal	verb
advocate	ወከል	wəkəl	noun
advocator	ሐጋዚት	ħəɡazit	noun
advocator	ሓገዝቲ	ħaɡəzɨti	noun
advocator	ወካሊ	wəkali	noun
advocator	ወካሊት	wəkalit	noun
affect	ጽለወ	t͡sʼɨləwə	verb
affirm	ኣመስለ	ʔaməsɨlə	verb
affirmable	ርግጻዊ	rɨɡɨt͡sʼawi	adj
after	ድሕሪ ሓጺር ግዜ	dɨħɨri ħat͡sʼirɨ ɡɨze	adv
afterwards	ቀጺሉ	qət͡sʼilu	adv
age	ኣረገ	ʔarəɡə	verb
age	ዕድመ ሂወት	ʕɨdɨmə hiwət	noun
agitate	ምዕግርጋር	mɨʕɨɡɨrɨɡar	verb
agitation	ምቕስቃስ	mɨqʰɨsɨqas	noun
agitation	ረብሻ	rəbɨʃa	noun
agony	ስሕግታ	sɨħɨɡɨta	noun
agreement	ኣውታረ ድምጺ	ʔawɨtarə dɨmɨt͡sʼi	noun
ahead	ብቕድሚ	bɨqʰɨdɨmi	adv
air	ኣናፈሰ	ʔanafəsə	verb
airplane	ኣይሮኘላን	ʔajɨroɲəlan	noun
airport	መዕረፍ ነፈርቲ	məʕɨrəfɨ nəfərɨti	noun
alarm	መሰማዕታ	məsəmaʕɨta	noun
alarm	መጠንቐቕታ	mətʼənɨqʰəqʰɨta	noun
alarm	ምጥንቓቕ	mɨtʼɨnɨqʰaqʰ	verb
alarm	ቓጭል	qʰat͡ʃʼɨl	noun
align	ምስራዕ	mɨsɨraʕ	verb
align	ረበበ	rəbəbə	verb
alliance	ምሕዝና	mɨħɨzɨna	noun
alone	ንብሕቶ	nɨbɨħɨto	adj
alone	እንኮ	ʔɨnɨko	adj
alone	ጽሙዋ	t͡sʼɨmuwa	adj
alphabet	ፈደል	fədəl	noun
amateur	ተልምደን	təlɨmɨdən	noun
amaze	ምድናቕ	mɨdɨnaqʰ	verb
amazed	ኣገራሚ	ʔaɡərami	adj
amazedly	ብምድናቕ	bɨmɨdɨnaqʰ	adv
amazedly	ብምግራም	bɨmɨɡɨram	adv
amuse	ምስሓቕ	mɨsɨħaqʰ	verb
amusement	መዛናጋዒ	məzanaɡaʕi	noun
anecdote	ትረት	tɨrət	noun
anger	ሕርቓን	ħɨrɨqʰan	noun
anger	ምኹራይ	mɨxuraj	verb
anger	ኩራ	kura	noun
angry	ኩርፍፍቲ	kurɨfɨfɨti	adj
angry	ኾራዪ	xoraji	adj
angry	ኾራይት	xorajɨt	adj
angry	ኾርፋፍ	xorɨfaf	adj
ankle	ኩርናዕ እግሪ	kurɨnaʕɨ ʔɨɡɨri	noun
ankle	ግንቦ እግሪ	ɡɨnɨbo ʔɨɡɨri	noun
announcement	ታእዋጅ	taʔɨwad͡ʒ	noun
ant-hill	ጉላ	ɡula	noun
antenna	ቅርኒብ ሓሸራ	qɨrɨnibɨ ħaʃəra	noun
anvil	ወጸቓ	wət͡sʼəqʰa	noun
anxiety	ሽግርግር	ʃɨɡɨrɨɡɨr	noun
anxious	ዝተሻቐለ	zɨtəʃaqʰələ	adj
anything	ገለኳ	ɡələkʷa	adv
apologize	ይቕረታ ሓተተ	jɨqʰɨrəta ħatətə	verb
appalling	ኣገራሚ	ʔaɡərami	adj
appearance	ምቕልቃል	mɨqʰɨlɨqal	noun
appearance	ወዝ	wəz	noun
applaud	ምምስጋን	mɨmɨsɨɡan	verb
applaud	ምጥቓዕ	mɨtʼɨqʰaʕ	verb
applaud	ኣንጨብጨበ	ʔanɨt͡ʃʼəbɨt͡ʃʼəbə	verb
applauder	መጣቐዕቲ	mətʼaqʰəʕɨti	noun
applauder	ኣጣቓዒት	ʔatʼaqʰaʕit	noun
applauder	ኣጣቓዓይ	ʔatʼaqʰaʕaj	noun
applause	ጨብጨብታ	t͡ʃʼəbɨt͡ʃʼəbɨta	noun
apple	ቱፉህ	tufuh	noun
apple	ቱፋህ	tufah	noun
apple tree	ቱፋሕ ገረብ	tufaħɨ ɡərəb	noun
applied	ትጉህ	tɨɡuh	adj
appreciable	ፉሉጥ	fulutʼ	adj
appreciate	ምምስጋን	mɨmɨsɨɡan	verb
appreciate	ኣመሰገነ	ʔaməsəɡənə	verb
apron	ግርምብያለ	ɡɨrɨmɨbɨjalə	noun
arch	ቀስተ	qəsɨtə	noun
ardour	ምዉቕ ስምዒት	mɨwuqʰɨ sɨmɨʕit	noun
argue	ምቁያቕ	mɨqujaqʰ	verb
argue	ምክታዕ	mɨkɨtaʕ	verb
armchair	ኩርሲ	kurɨsi	noun
arms	የእዳዎ	jəʔɨdawo	noun
arrange	ኣማዓራረየ	ʔamaʕararəjə	verb
artery	ሰራውር	sərawɨr	noun
artist	ሳኣላይ	saʔalaj	noun
as much	ክሳብ ክንድኡ	kɨsabɨ kɨnɨdɨʔu	adv
ashamed	ዘሕፍር	zəħɨfɨr	adj
ashes	ሓሙኹሽቲ	ħamuxuʃɨti	noun
ask for	ተጣረዐ	tətʼarəʕə	verb
assert	ኣመስለ	ʔaməsɨlə	verb
assurance	መተኣማመኒ	mətəʔamaməni	noun
astonish	ኣገረሀ	ʔaɡərəhə	verb
astonishment	ድንጽዉና	dɨnɨt͡sʼɨwuna	noun
at last	ኣብ መዳእታ	ʔabɨ mədaʔɨta	adv
at least	ብዉሕድ	bɨwuħɨd	adv
attention	ኣስተውዕል	ʔasɨtəwɨʕɨl	noun
attention	ኣድህብ	ʔadɨhɨb	noun
attentive	መስተውዓሊት	məsɨtəwɨʕalit	adj
attentive	ኣድሃቢ	ʔadɨhabi	adj
aunt (father's side)	ኣሞ	ʔamo	noun
aunt (mother's side)	ሓትነ	ħatɨnə	noun
aunt (mother's side)	ሓትኖ	ħatɨno	noun
author	ጸሓፊት	t͡sʼəħafit	noun
authority	ሰበ ስልጣን	səbə sɨlɨtʼan	noun
autumnal	ናይ ቀውዒ	najɨ qəwɨʕi	adj
avenue	ዓብይ ጎደና	ʕabɨjɨ ɡodəna	noun
awakening	ሓዲሽ ምጅማር	ħadiʃɨ mɨd͡ʒɨmar	noun
awakening	ትንሳኤ	tɨnɨsaʔe	noun
away	ቦኾረ	boxorə	verb
axe	ቅርቅረ ዑፍ	qɨrɨqɨrə ʕuf	noun
baby	ሕጻን	ħɨt͡sʼan	noun
back	ሕቆ	ħɨqo	noun
bad luck	ቅርሳሰ	qɨrɨsasə	noun
baggage	ኣቑሑ ጉዕዞ	ʔaqʰuħu ɡuʕɨzo	noun
baker	ሰንካቲ	sənɨkati	noun
baker	ሰንካቲት	sənɨkatit	noun
balcony	ባልኮን	balɨkon	noun
bandage	ቺረቶ	t͡ʃirəto	noun
bandage	ኣተሓኻኸማ	ʔatəħaxaxəma	noun
bang	ምህራም	mɨhɨram	verb
bang	ምዝባጥ	mɨzɨbatʼ	verb
bank	ባንክ	banɨk	noun
banker	ባንከኛ	banɨkəɲa	noun
baptism	ጥምቀት	tʼɨmɨqət	noun
bar	ቤት መስተ	betɨ məsɨtə	noun
barbed wire	ትሪኮላታ	tɨrikolata	noun
barber	ቀምቃሚ	qəmɨqami	noun
bark	ቅላጥ ዕንጨይቲ	qɨlatʼɨ ʕɨnɨt͡ʃʼəjɨti	noun
bark	ነብሐ	nəbɨħə	verb
barley	ስገም	sɨɡəm	noun
barn	መኽዘን አኽሊ	məxɨzənɨ ʔəxɨli	noun
barrel	ፊስቶ	fisɨto	noun
basil	ባዘሊኮ	bazəliko	noun
basil	ቤዚል	bezil	noun
bath	ምሕጻብ ነብሲ	mɨħɨt͡sʼabɨ nəbɨsi	noun
bathe	ተሓጸበ	təħat͡sʼəbə	verb
battalion	ቦጦሎኒ	botʼoloni	noun
battery	ኮቦሮ ኦርከስትራ	koboro ʔorɨkəsɨtɨra	noun
bawl	ገዓረ	ɡəʕarə	verb
be	ተገረመ	təɡərəmə	verb
be absent	ጎደለ	ɡodələ	verb
be afraid	ፈርሐ	fərɨħə	verb
be alive	ምትንፋስ	mɨtɨnɨfas	verb
be astonished	ተገረመ	təɡərəmə	verb
be born	ተወለደ	təwələdə	verb
be delighted	ተሓጎሰ	təħaɡosə	verb
be restored	ጠዓየ	tʼəʕajə	verb
be sorry	ተጣዓሰ	tətʼaʕasə	verb
be welcome	ደሓን ምጽ	dəħanɨ mɨt͡sʼ	adj
be worth	ክብሪ ዘለዎ	kɨbɨri zələwo	verb
be/present	ኣሎ	ʔalo	verb
beak	መትኮብ ዑፍ	mətɨkobɨ ʕuf	noun
bean	ፋጆሊ	fad͡ʒoli	noun
beans	ባሎንኌ	balonɨhʷe	noun
beard	ጭሕሚ	t͡ʃʼɨħɨmi	noun
become	ተስፋ ቆረጸ	təsɨfa qorət͡sʼə	verb
become rich	ሃብተመ	habɨtəmə	verb
beech	ቢቸ	bit͡ʃə	noun
beer	ቢርራ	birɨra	noun
beet	ቀይሕ ሱር	qəjɨħɨ sur	noun
begin	ምጅማር	mɨd͡ʒɨmar	noun
beginner	ተልምደን	təlɨmɨdən	noun
behave	ትኣደበ	tɨʔadəbə	verb
behind	ብድሕሪ	bɨdɨħɨri	adv
bell	ደውል	dəwɨl	noun
benefactor	ገባር ሰናይ	ɡəbarɨ sənaj	noun
benefit	ጽቡቕ ግብሪ	t͡sʼɨbuqʰɨ ɡɨbɨri	noun
beret	ቆቢዕ ከቢብ	qobiʕɨ kəbib	noun
betray	ከድዐ	kədɨʕə	verb
big	ረጉድ	rəɡud	adj
biology	ባዮሎጂ	bajolod͡ʒi	noun
bird	ጭሩ	t͡ʃʼɨru	noun
biscuit	ቢስኮቲ	bisɨkoti	noun
black pepper	በርበረ ጸሊም	bərɨbərə t͡sʼəlim	noun
bladder	ፊሕኛ	fiħɨɲa	noun
blanket	ኮቦርታ	koborɨta	noun
bleat	እምቤዕ በለ	ʔɨmɨbeʕɨ bələ	verb
blind	ዓይነ ስዉር	ʕajɨnə sɨwur	adj
blot	ንጣብ ርስሓት	nɨtʼabɨ rɨsɨħat	noun
blotting-paper	ሰታይ ቀለም	sətajɨ qələm	noun
blouse	ካሚሻ	kamiʃa	noun
blow	ኡፍ በለ	ʔufɨ bələ	verb
blow up	ተባርዐ	təbarɨʕə	verb
board	መንደቒ ኡሕ	mənɨdəqʰi ʔuħ	noun
boast	ፈከረ	fəkərə	verb
boat	ባቡር ቀላይ	baburɨ qəlaj	noun
body	ነብሲ	nəbɨsi	noun
boiled beef	ብሱል ስጋ	bɨsulɨ sɨɡa	noun
bombardment	ደብዳብ	dəbɨdab	noun
boring	መሰልከዊ	məsəlɨkəwi	adj
borrow	ተለቀሐ	tələqəħə	verb
boss	ኣስራሒት	ʔasɨraħit	noun
botany	ስነ ኣትክልቲ	sɨnə ʔatɨkɨlɨti	noun
bother	ጸገመ	t͡sʼəɡəmə	verb
bottom	ካልሲ ነዊሕ	kalɨsi nəwiħ	noun
boulevard	ገፊሕ ጎደና	ɡəfiħɨ ɡodəna	noun
brain	ሐንጎል	ħənɨɡol	noun
branch	እሾኽ ገረብ	ʔɨʃoxɨ ɡərəb	noun
brass band	ጥሩምበኛታት	tʼɨrumɨbəɲatat	noun
breach	ሽሮፍ	ʃɨrof	noun
break	ተፈንጠለ	təfənɨtʼələ	verb
breakfast	ቆረሰ	qorəsə	verb
breathe	ኣተንፈሰ	ʔatənɨfəsə	verb
brick	ሑጡብ	ħutʼub	noun
bridge	መዓሸግ ባብር	məʕaʃəɡɨ babɨr	noun
bring	ዓለመ	ʕaləmə	verb
bring in the grape	ወይኒ ኣረየ	wəjɨni ʔarəjə	verb
brochure	መጽሓፍ ጸብጻብ	mət͡sʼɨħafɨ t͡sʼəbɨt͡sʼab	noun
brother	ሓወ	ħawə	noun
brush	መስኣሊ ኣስባስላ	məsɨʔali ʔasɨbasɨla	noun
brutal	በዓለገ	bəʕaləɡə	adj
brutal	ኣረመና	ʔarəməna	adj
bucket	ሳንኮሎ	sanɨkolo	noun
building	ርሻን	rɨʃan	noun
bullet	ጥይት	tʼɨjɨt	noun
bumblebee	ዕንዛርያ	ʕɨnɨzarɨja	noun
bump	መንዳዓት	mənɨdaʕat	noun
burst	ነቶገ	nətoɡə	verb
bush	ሰርነግ	sərɨnəɡ	noun
bush	ቆትቋጥ	qotɨqʷatʼ	noun
but	ግና	ɡɨna	conj
butcher's shop	እንዳ ስጋ ሓሰማ	ʔɨnɨda sɨɡa ħasəma	noun
cabbage	ካዉሎ ካፑቺ	kawulo kaput͡ʃi	noun
calculator	መሓሰበት	məħasəbət	noun
calf	ምራኽ	mɨrax	noun
calf	ፈርሲ ዳንጋ	fərɨsi danɨɡa	noun
calm	ፍሲህ	fɨsih	adj
candy	ካራመለ	karamələ	noun
cap	ቆቢዕ	qobiʕ	noun
capital	ርእሰ ማል	rɨʔɨsə mal	noun
capital	ርእሲ ከተማ	rɨʔɨsi kətəma	noun
card game	ጣላዕ	tʼalaʕ	noun
cardboard	ካርቶን	karɨton	noun
care	ክንከን	kɨnɨkən	noun
career	መስርሕ ሂወት	məsɨrɨħɨ hiwət	noun
carpenter	ናሕሲ ዝሰርሕ	naħɨsi zɨsərɨħ	noun
carrot	ካሮት	karot	noun
caterpillar	ኣብ ጨጎራ	ʔabɨ t͡ʃʼəɡora	noun
cathedral	ቤተ ክርስቲያን	betə kɨrɨsɨtijan	noun
cauliflower	ካውሎ ፊየሪ	kawɨlo fijəri	noun
cause	ኣግበረ	ʔaɡɨbərə	verb
ceiling	ትሕቲ ናሕሲ	tɨħɨti naħɨsi	noun
celery	ሰዴኖ	sədeno	noun
cement	ቸመንቶ	t͡ʃəmənɨto	noun
centimetre	ሰንቲ ሜተረ	sənɨti metərə	noun
centre of the	መርዓት ዓይኒ	mərɨʕatɨ ʕajɨni	noun
century	ክፍለ ዘመን	kɨfɨlə zəmən	noun
certain	ርግጽ	rɨɡɨt͡sʼ	adj
certainly	ርጉጻዊ	rɨɡut͡sʼawi	adv
certificate	ባጀላ	bad͡ʒəla	noun
chair	ሴዳ	seda	noun
chalk	ኩርሽ	kurɨʃ	noun
chapel	ቤተ ጸሎት	betə t͡sʼəlot	noun
charm	ምጥውና	mɨtʼɨwɨna	noun
charming	ምጥው	mɨtʼɨw	adj
chauffeur	ዘዋር መኪና	zəwarɨ məkina	noun
cheek	ሙዕጉርቲ	muʕɨɡurɨti	noun
cheek	ጉንጪ	ɡunɨt͡ʃʼi	noun
cheek	ምዕጉርቲ	mɨʕɨɡurɨti	noun
cheese	ጀብና	d͡ʒəbɨna	noun
chemistry	ኬሚስትራ	kemisɨtɨra	noun
cherish	ኣሐንቀቐ	ʔaħənɨqəqʰə	verb
cherry tree	ቸሪ ገረብ	t͡ʃəri ɡərəb	noun
chest	ኣፍ ልቢ	ʔafɨ lɨbi	noun
chest of drawers	ኮሞ	komo	noun
chestnut	ፍረ ቸስትናት	fɨrə t͡ʃəsɨtɨnat	noun
chestnut-tree	ገረብ ቸስትናት	ɡərəbɨ t͡ʃəsɨtɨnat	noun
chicken	ጫቚት ደርሆ	t͡ʃʼaqʰʷitɨ dərɨho	noun
chickpea	ዓተር	ʕatər	noun
child	ሕጻን	ħɨt͡sʼan	noun
child	ቆልዓ	qolɨʕa	noun
childhood	ሕጻንነት	ħɨt͡sʼanɨnət	verb
chilly	ቆራሪ	qorari	adj
chimney sweep	ጠቐር ዘጽሪ	tʼəqʰərɨ zət͡sʼɨri	noun
chin	መንከስ	mənɨkəs	noun
chocolate	ቸኮላታ	t͡ʃəkolata	noun
choir	መሃምራን	məhamɨran	noun
choral	ናይ መሃምራን	najɨ məhamɨran	adj
chorus	መሃምራን	məhamɨran	noun
chuckle	ቐቐወ	qʰəqʰəwə	verb
church tower	እንዳ ደወል	ʔɨnɨda dəwəl	noun
circulation	ምዝዋር	mɨzɨwar	noun
circus	ሰርከስ	sərɨkəs	noun
citizen	ተቐማጢት	təqʰəmatʼit	noun
city	ቤተ ጽሕፈት	betə t͡sʼɨħɨfət	noun
civilization	ስልጣኔ	sɨlɨtʼane	noun
claim	ተጣረዐ	tətʼarəʕə	verb
clap	ኣንጨብጨበ	ʔanɨt͡ʃʼəbɨt͡ʃʼəbə	verb
clash	ተናጎጸ	tənaɡot͡sʼə	verb
classmate	መማህርተይ	məmahɨrɨtəj	noun
classmate (female)	ጓል ክፍሊ	ɡʷalɨ kɨfɨli	noun
classmate (male)	ወዲ ክፍሊ	wədi kɨfɨli	noun
clear	ብፍላጥ	bɨfɨlatʼ	adv
clear	ዝረአ	zɨrəʔə	adj
clear	ዝተቖጥቆጠ	zɨtəqʰotʼɨqotʼə	adj
clearing	ቃልዕ ቦታ	qalɨʕɨ bota	noun
clearness	ብራሃን	bɨrahan	noun
clever	ጎራሕ	ɡoraħ	adj
clockmaker	ሰራሕ ሰዓት	səraħɨ səʕat	noun
closed	ዕጽዉ	ʕɨt͡sʼɨwu	adj
cluster	ጎጅለ	ɡod͡ʒɨlə	verb
coffin	ሳጹን ሬሳ	sat͡sʼunɨ resa	noun
cold	ቆራሪ	qorari	adj
collar	ክሳድ ጎቦ	kɨsadɨ ɡobo	noun
collect	ምእካብ ግብሪ	mɨʔɨkabɨ ɡɨbɨri	verb
collection of	እኩብ መጻሕፍቲ	ʔɨkubɨ mət͡sʼaħɨfɨti	noun
college	ላዕላይ	laʕɨlaj	noun
colonel	ኮሮነል	koronəl	noun
colour	ሕብሪ ለኸየ	ħɨbɨri ləxəjə	verb
colourless	ሕብሪ ዘይብሉ	ħɨbɨri zəjɨbɨlu	adj
comb	መመሸጥ	məməʃətʼ	noun
come back	እንደገና መጸ	ʔɨnɨdəɡəna mət͡sʼə	verb
come down	እንደገና ወረደ	ʔɨnɨdəɡəna wərədə	verb
come from	ተለዓለ	tələʕalə	verb
comfort	ቅሳነተ	qɨsanətə	noun
commerce	ንግዲ	nɨɡɨdi	noun
commercial area	ዞባ ዕዳጋ	zoba ʕɨdaɡa	adj
committee	ኮሚተ	komitə	noun
communal	ኣሃዳዊ	ʔahadawi	adj
communion	ቁርባን	qurɨban	noun
company	ኣሰናይ	ʔasənaj	noun
complicate	ኣሕለኽለኸ	ʔaħɨləxɨləxə	verb
compose	ወረበ	wərəbə	verb
computer	ካምፑትር	kamɨputɨr	noun
conceal	ሰተረ	sətərə	verb
conceit	ትዕቢት	tɨʕɨbit	noun
condemnation	ኩነና	kunəna	noun
confusion	ጽልግልግ	t͡sʼɨlɨɡɨlɨɡ	noun
congratulate	እንቋዕ ሓጎሰካ በለ	ʔɨnɨqʷaʕɨ ħaɡosəka bələ	verb
congratulations	መግለጺ ሓጎስ	məɡɨlət͡sʼi ħaɡos	noun
conscience	ሕልና	ħɨlɨna	noun
contagion	ሕማም ምትሕልላፍ	ħɨmamɨ mɨtɨħɨlɨlaf	noun
contractor	ሰራሕ ገዛ	səraħɨ ɡəza	noun
contradict	ተቓረነ	təqʰarənə	verb
contradiction	ግርጭት	ɡɨrɨt͡ʃʼɨt	noun
contribute	ኣብርከተ	ʔabɨrɨkətə	verb
convert	እምነት ኣለወጠ	ʔɨmɨnətɨ ʔaləwətʼə	verb
convert oneself	እምነት ለወጠ	ʔɨmɨnətɨ ləwətʼə	verb
convince	ኣእመነ	ʔaʔɨmənə	verb
cook	ከሻኒት	kəʃanit	noun
cooker	ፎርነሎ	forɨnəlo	noun
cookie	ቢስኮቲ	bisɨkoti	noun
copy	ቐድሐ	qʰədɨħə	verb
corn	ቅርኒብ እኽሊ	qɨrɨnibɨ ʔɨxɨli	noun
corn	ዑፉን	ʕufun	noun
corner	ኣንጎሎ	ʔanɨɡolo	noun
corporal	ቡንጣዝ	bunɨtʼaz	noun
correspondence	ርኽክብ	rɨxɨkɨb	noun
corridor	ኮረደዮ	korədəjo	noun
cost	ኣውጸአ ዋጋ	ʔawɨt͡sʼəʔə waɡa	verb
cost	ክብሪ ዘለዎ	kɨbɨri zələwo	verb
cough	ሑአታ	ħuʔəta	noun
cough	ሰዓለ	səʕalə	verb
cough	ሰዓል	səʕal	noun
coughing	ሰዓል	səʕal	noun
councillor	ኣማኻሪት	ʔamaxarit	noun
counter	ቆጻሪ	qot͡sʼari	noun
country	ወዲ ገጠር	wədi ɡətʼər	adj
couple	ሰብ ሓዳር	səbɨ ħadar	noun
courageously	ብትብዓት	bɨtɨbɨʕat	adv
courier	ደብዳቤ	dəbɨdabe	noun
course	ኮርስ	korɨs	noun
courthouse	ቤተ ፍርዲ	betə fɨrɨdi	noun
cousin (father's)	ወዲ ሓወቦ	wədi ħawəbo	noun
cousin (father's)	ወዲ ኣሞ	wədi ʔamo	noun
cousin (father's)	ጓል ሓወቦ	ɡʷalɨ ħawəbo	noun
cousin (father's)	ጓል ኣሞ	ɡʷalɨ ʔamo	noun
cousin (mother's)	ወዲ ሓትኖ	wədi ħatɨno	noun
cousin (mother's)	ወዲ ኣኮ	wədi ʔako	noun
cousin (mother's)	ጓል ሓትነ	ɡʷalɨ ħatɨnə	noun
cousin (mother's)	ጓል ኣኮ	ɡʷalɨ ʔako	noun
cover	መኽደኒ ድስቲ	məxɨdəni dɨsɨti	noun
cover	ሰተረ	sətərə	verb
cover	ኮቦርታ	koborɨta	noun
cover oneself up	ተጎልበበ	təɡolɨbəbə	verb
cowardice	ጁርቅና	d͡ʒurɨqɨna	noun
crack	ተፈንጠለ	təfənɨtʼələ	verb
cradle	ዓራት ሕጻን	ʕaratɨ ħɨt͡sʼan	noun
crafty	ሃሳይ	hasaj	adj
crane	ሰፍሳፊት	səfɨsafit	noun
crawl	ለመመ	ləməmə	verb
creamery	እንዳ ጸባ	ʔɨnɨda t͡sʼəba	noun
crisis	ጥቕዓት	tʼɨqʰɨʕat	noun
cross	ተሳገረ	təsaɡərə	verb
cross	ተናጠረ	tənatʼərə	verb
crossroads	መስቀላዊ መንገዲ	məsɨqəlawi mənɨɡədi	noun
crowd	ጽቕጥቅጥ	t͡sʼɨqʰɨtʼɨqɨtʼ	noun
crowd	ጽዑቕ ህዝቢ	t͡sʼɨʕuqʰɨ hɨzɨbi	noun
crown	ዘውዲ ደፍአ	zəwɨdi dəfɨʔə	verb
crumb	ርፍራፍ	rɨfɨraf	noun
crumb	ውሽጢ ባኒ	wɨʃɨtʼi bani	noun
crush	ኣጽፈሐ	ʔat͡sʼɨfəħə	verb
crust	ቅራፍ ባኒ	qɨrafɨ bani	noun
crystal	ሓቒቕ	ħaqʰiqʰ	noun
cultivated	ኩስኩስ	kusɨkus	adj
cunning	ሃሳይ	hasaj	adj
cunning	ጎራሕ	ɡoraħ	adj
cup	ኣቃድዳ	ʔaqadɨda	noun
cup	ኣቋራርጻ	ʔaqʷararɨt͡sʼa	noun
cupboard	ኣርማድዮ ክሽነ	ʔarɨmadɨjo kɨʃɨnə	noun
cure	ሓወየ	ħawəjə	verb
curiosity	ህንጥይና	hɨnɨtʼɨjɨna	noun
curly	ኮርዳድ ጸጉሪ	korɨdadɨ t͡sʼəɡuri	adj
curse	ረገመ	rəɡəmə	verb
curtain	መጋረጀ	məɡarəd͡ʒə	noun
curved	ጥዉይ	tʼɨwuj	adj
cyclist	ዘዋር ብሽክለታ	zəwarɨ bɨʃɨkɨləta	noun
dairy	እንዳ ጸባ	ʔɨnɨda t͡sʼəba	noun
damage	ኣባላሸወ	ʔabalaʃəwə	verb
dance	ሳዕሰዐ	saʕɨsəʕə	verb
dangerous	ሓደገኛ	ħadəɡəɲa	adj
date	ዕለት ገበረ	ʕɨlətɨ ɡəbərə	verb
dazzle	ዓይነ ስዉር	ʕajɨnə sɨwur	adj
debate	ተኻተዐ	təxatəʕə	verb
debris	ርፍራፍ	rɨfɨraf	noun
deceive	ከድዐ	kədɨʕə	verb
deck	መዓሸግ ባብር	məʕaʃəɡɨ babɨr	noun
decline	ጐደለ	ɡʷədələ	verb
decorative	ስልማታዊ	sɨlɨmatawi	adj
defer	ኣደንጎየ	ʔadənɨɡojə	verb
define	ወሰአነ	wəsəʔənə	verb
deforest	ኣበደመ	ʔabədəmə	verb
delay	ኣደንጎየ	ʔadənɨɡojə	verb
delay	ደንጎየ	dənɨɡojə	verb
delinquency	ጽየቓ	t͡sʼɨjəqʰa	noun
delivery man	ኣባጻጽሒ	ʔabat͡sʼat͡sʼɨħi	noun
delude	ራረወ	rarəwə	verb
delusional	ጽልልቲ	t͡sʼɨlɨlɨti	adj
demand	ተጣረዐ	tətʼarəʕə	verb
demolish	ኣፍራሰ	ʔafɨrasə	verb
departing ticket	ቲከት መኸዲ	tikətɨ məxədi	noun
departure	ተበገሶ	təbəɡəso	noun
deposit	ቅሙጥ ጜኝዤብ	qɨmutʼɨ ɲɨʒeb	noun
depth	ዕምቆት	ʕɨmɨqot	noun
deputy	ወኪል ህዝቢ	wəkilɨ hɨzɨbi	noun
desert	ምድረ በዳ	mɨdɨrə bəda	noun
deserted	ምድረ በዳ	mɨdɨrə bəda	noun
deserve	ተገበአ	təɡəbəʔə	verb
desk	ጠረጰዛ	tʼərəpʼəza	noun
despair	ተስፋ ኣልቦነት	təsɨfa ʔalɨbonət	noun
despair	ቅብጸተ ተስፋ	qɨbɨt͡sʼətə təsɨfa	noun
destiny	ዕድልነት	ʕɨdɨlɨnət	noun
devotion	ውፉይነት	wɨfujɨnət	noun
dew	ዛዕዛዕታ	zaʕɨzaʕɨta	noun
dial	ገጽ ሰዓት	ɡət͡sʼɨ səʕat	noun
dictation	እተባህለ	ʔɨtəbahɨlə	noun
dictionary	መዝገበ ቃላት	məzɨɡəbə qalat	noun
different	ዝተፈለየ	zɨtəfələjə	adj
difficult	ኣጨናቒ	ʔat͡ʃʼənaqʰi	adj
dine	ተደረረ	tədərərə	verb
dining room	መመገቢ ክፍሊ	məməɡəbi kɨfɨli	noun
direct	ቀጥታ	qətʼɨta	adj
direct	ቐጥታዊ	qʰətʼɨtawi	adj
direction	ኣቅጣጫ	ʔaqɨtʼat͡ʃʼa	noun
directly	ብቐጥ	bɨqʰətʼ	adv
disappear	ሃለዋት ኣጥፈአ	haləwatɨ ʔatʼɨfəʔə	verb
disappear	ተሰወረ	təsəwərə	verb
discharge	ኣሰናበተ	ʔasənabətə	verb
discipline	ስነ ስርዓት	sɨnə sɨrɨʕat	noun
discomfort	ዘይጥጣሐ	zəjɨtʼɨtʼaħə	noun
discourage	ተስፋ ዝቖረጸ	təsɨfa zɨqʰorət͡sʼə	adj
discuss	ተላዘበ	təlazəbə	verb
discuss	ተኻተዐ	təxatəʕə	verb
discussion	ክትዐ	kɨtɨʕə	noun
dishes	ኣቑሑ መግቢ	ʔaqʰuħu məɡɨbi	noun
dislodge	ቦታ ቀየረ	bota qəjərə	verb
dismiss	ኣሰነበተ	ʔasənəbətə	verb
dismiss	ኣሰናበተ	ʔasənabətə	verb
disobedient	ዘይምቕሉል	zəjɨmɨqʰɨlul	adj
disobey	ዘይምእዛዝ	zəjɨmɨʔɨzaz	verb
disorder	ፋሕ ዝበለ	faħɨ zɨbələ	noun
displeased	ዘይሕጉስ	zəjɨħɨɡus	adj
disprove	ስንኩሌ	sɨnɨkule	adj
dive	ተደርገመ	tədərɨɡəmə	verb
divorce	ዝተፋትሐ	zɨtəfatɨħə	adj
do one's best	ጸዓረ	t͡sʼəʕarə	verb
dock	ጠጠ ኣበለ	tʼətʼə ʔabələ	verb
doctor	ዶክቶር	dokɨtor	noun
dog house	ገዛ ኸልቢ	ɡəza xəlɨbi	noun
domestic	ቤተ ሰባዊ	betə səbawi	adj
donkey	ኣድጊ	ʔadɨɡi	noun
doorstep	ደርኩኺት	dərɨkuxit	noun
doorstep	ደርኩኺት	dərɨkuxit	noun
doubt	ጥርጥር	tʼɨrɨtʼɨr	noun
dough	ቢሑቕ	biħuqʰ	noun
drafting	ኣባላት ቤት ማሕተም	ʔabalatɨ betɨ maħɨtəm	noun
draw	ኣሰር ኣውጸአ	ʔasərɨ ʔawɨt͡sʼəʔə	verb
draw water	ገለለ	ɡələlə	verb
dressing	ኣተሓኻኸማ	ʔatəħaxaxəma	noun
dressmaker	ሰፋይ ክዳን	səfajɨ kɨdan	noun
drink	መሰተ	məsətə	verb
drum	ኮቦሮ	koboro	noun
dry	ኣንቀጸ	ʔanɨqət͡sʼə	verb
dry	ደረቐ	dərəqʰə	verb
dull	ጎዲም	ɡodim	adj
duty	ጉቡእ	ɡubuʔ	noun
dwarf	ድንኪ	dɨnɨki	noun
dwelling	ጽንሒት	t͡sʼɨnɨħit	noun
dying	መዋቲ	məwati	adj
ear	ኣዝኒ	ʔazɨni	noun
early	ኣቐዲምካ ዝግበር	ʔaqʰədimɨka zɨɡɨbər	adj
early	ናይ ንጉሆ	najɨ nɨɡuho	adj
ease	ቅሊ	qɨli	noun
easily	ብምቾት	bɨmɨt͡ʃot	adv
easiness	ቅሊ	qɨli	noun
east	ምብራቅ	mɨbɨraq	noun
easterly	ምብራቅ	mɨbɨraq	noun
echo	መቓልሕ ሃበ	məqʰalɨħɨ habə	verb
edge	ወሰን ወሰን	wəsənɨ wəsən	noun
edible	ዝብላዕ	zɨbɨlaʕ	adj
edition	ስንዳእ	sɨnɨdaʔ	noun
egg-plant	መለንዛና	mələnɨzana	noun
eggs	ኣንቋቝሖ	ʔanɨqʷaqʰʷɨħo	noun
egoism	ስስዐ	sɨsɨʕə	noun
eighteen	ዓሰርተ ሸሞንተ	ʕasərɨtə ʃəmonɨtə	noun
eighth grade	ሻሙናይ ክፍሊ	ʃamunajɨ kɨfɨli	noun
eighty	ሰማንያ	səmanɨja	noun
elbow	ኩርናዕ ኢድ	kurɨnaʕɨ ʔid	noun
elder	ቦኹሪ	boxuri	adj
eldest	ቦኹሪ	boxuri	adj
elementary	መባእታ ደረጃ	məbaʔɨta dərəd͡ʒa	noun
eleventh	ዓሰርተ ሓደ ክፍሊ	ʕasərɨtə ħadə kɨfɨli	noun
elsewhere	ኣብ ካልእ ቦታ	ʔabɨ kalɨʔɨ bota	adv
emerge	ቅልቅል በለ	qɨlɨqɨlɨ bələ	verb
employ	ኣስረሐ	ʔasɨrəħə	verb
employ	ዓያዪ ኣሕደረ	ʕajaji ʔaħɨdərə	verb
employee	ጸሐፊ	t͡sʼəħəfi	noun
employer	ዋሃብ ስራሕ	wahabɨ sɨraħ	noun
empress	ኡቴገ	ʔuteɡə	noun
enemy	ጸላኢ	t͡sʼəlaʔi	noun
engine	ሞተር	motər	noun
enjoy	ደስ በሎ	dəsɨ bəlo	verb
enormous	ረኣምራታዊ	rəʔamɨratawi	adj
enterprise	ወኒነ ትካል	wəninə tɨkal	noun
entrance	መእተዊ ክፍሊ	məʔɨtəwi kɨfɨli	noun
equal	ጽምዲ ቁጽሪ	t͡sʼɨmɨdi qut͡sʼɨri	adj
equipment	ነገር ንዋት	nəɡərɨ nɨwat	noun
escape	መለቐ	mələqʰə	verb
escape from	ሞሎቐ	moloqʰə	verb
establish	መሰረተ	məsərətə	verb
estimate	ኣልያሉ ገመተ	ʔalɨjalu ɡəmətə	verb
eternal	ዘላኣለማዊ	zəlaʔaləmawi	adj
eternity	ዘላኣለም	zəlaʔaləm	noun
even	ጽምዲ ቁጽሪ	t͡sʼɨmɨdi qut͡sʼɨri	adj
everywhere	ኣብ ኩኡ ቦታ	ʔabɨ kuʔu bota	adv
exchange	ለዋወጠ	ləwawətʼə	verb
excitement	ምቕስቃስ	mɨqʰɨsɨqas	noun
exclude	ፈልዩ ኣትረፈ	fəlɨju ʔatɨrəfə	verb
exhausted	ውዲእ	wɨdiʔ	adj
existence	ህላዌ	hɨlawe	noun
expand	ኣሰፍሐ	ʔasəfɨħə	verb
explicit	ብፍላጥ	bɨfɨlatʼ	adv
explode	ተባርዐ	təbarɨʕə	verb
explode	ነቶገ	nətoɡə	verb
express	ሓሳብ ገለጸ	ħasabɨ ɡələt͡sʼə	verb
express train	ቅልጡፍ ባቡር	qɨlɨtʼufɨ babur	noun
extend	ኣናውሐ	ʔanawɨħə	verb
external	ድጋዊ	dɨɡawi	adj
eyebrow	ሸፋሽፍቲ ዓይኒ	ʃəfaʃɨfɨti ʕajɨni	noun
eyebrow	ጨጉሪ ዓይኒ	t͡ʃʼəɡuri ʕajɨni	noun
eyelash	ቅርኒብ ዓይኒ	qɨrɨnibɨ ʕajɨni	noun
eyelash	ቕርኒብ ዓይኒ	qʰɨrɨnibɨ ʕajɨni	noun
eyelid	ኮቦሮ ዓይኒ	koboro ʕajɨni	noun
face to face	ገጽ ንገጽ	ɡət͡sʼɨ nɨɡət͡sʼ	adv
factory	ቤተ ዕዮ	betə ʕɨjo	noun
faded	ቅሁም	qɨhum	adj
fail	ምትራፍ	mɨtɨraf	verb
fail	ምውዳቕ	mɨwɨdaqʰ	verb
failed	ተሪፈ	tərifə	adj
failed	ወዲቐ	wədiqʰə	adj
faint	ቀልቡ	qəlɨbu	verb
fall again	እንደገና ወደቐ	ʔɨnɨdəɡəna wədəqʰə	verb
family	ስድራ ቤት	sɨdɨra bet	noun
family	ቤተ ሰባዊ	betə səbawi	adj
farm	ናይ ሕርሻ ገዛ	najɨ ħɨrɨʃa ɡəza	noun
farmer	ዓኳይ	ʕakʷaj	noun
fatal	ዘይተርፍ	zəjɨtərɨf	adj
fatherly	ኣብታዊ	ʔabɨtawi	adj
favour	ኣዛዘወ	ʔazazəwə	verb
favour	ኣርሰሐ	ʔarɨsəħə	verb
favourite	ዕቑብ	ʕɨqʰub	noun
fear	ስጌኣት	sɨɡeʔat	noun
fear	ፈርሐ	fərɨħə	verb
fear	ፍርሂ	fɨrɨhi	verb
feed	ተመገበ	təməɡəbə	verb
feel	ተሰምዖ	təsəmɨʕo	verb
female	ኣንስተይቲ	ʔanɨsɨtəjɨti	noun
female director	ሓላፊት	ħalafit	noun
female guard	ሓላዊት	ħalawit	noun
feminine	ኣንስታይ	ʔanɨsɨtaj	adj
fence	ተኽሊ ሓጹር	təxɨli ħat͡sʼur	noun
ferment	ቦኽዐ	boxɨʕə	verb
fertile	ፈራይ	fəraj	adj
feverish	ርሱን	rɨsun	adj
fiancée	ሕጺቲ	ħɨt͡sʼiti	verb
field	ጎልጉል	ɡolɨɡul	noun
fierce	ኣረመና	ʔarəməna	adj
fifth grade	ሓሙሻይ ክፍሊ	ħamuʃajɨ kɨfɨli	noun
finally	መወዳእትኢ	məwədaʔɨtɨʔi	adv
finally	ኣብ መዳእታ	ʔabɨ mədaʔɨta	adv
find	ረከበ	rəkəbə	verb
finger nails	ጽፍሪ ኢድ	t͡sʼɨfɨri ʔid	noun
fingers	አጻብዕቲ ኢድ	ʔət͡sʼabɨʕɨti ʔid	noun
finish	ጨረሰ	t͡ʃʼərəsə	verb
first grade	ቀዳማይ ክፍሊ	qədamajɨ kɨfɨli	noun
fishhook	መቑለብ ዓሳ	məqʰuləbɨ ʕasa	noun
fist	ዕምኮ	ʕɨmɨko	noun
flag	ባንደራ	banɨdəra	noun
flat round unleavened	ቂጫ	qit͡ʃʼa	noun
flat round unleavened	ጐጐ	ɡʷəɡʷə	noun
flatly	ጽሩይ ውጹእ	t͡sʼɨrujɨ wɨt͡sʼuʔ	adj
flatten	ኣጽፈሐ	ʔat͡sʼɨfəħə	verb
float	ተንስፈፈ	tənɨsɨfəfə	verb
flock	መጓሰ	məɡʷasə	noun
flood	ዕልቅቕልቕ	ʕɨlɨqɨqʰɨlɨqʰ	noun
flood gate	ሰጋጥ	səɡatʼ	noun
flow	ጎየየ	ɡojəjə	verb
flu	ኡንፍልወንዛ	ʔunɨfɨlɨwənɨza	noun
fly	ሃመማ	haməma	noun
foggy	ግማዊ	ɡɨmawi	adj
foot	መሓውር እንስሳ	məħawɨrɨ ʔɨnɨsɨsa	noun
football	ኩእሶ እግሪ	kuʔɨso ʔɨɡɨri	noun
foreign	ባእዳዊ	baʔɨdawi	adj
foresee	ተተንበየ	tətənɨbəjə	verb
forget	ረሰዐ	rəsəʕə	verb
forgetfulness	ርሳዐ	rɨsaʕə	noun
forgetting	ርሳዐ	rɨsaʕə	noun
fork	ፋርከታ	farɨkəta	noun
formerly	ኣብ ሕሉፍ እዋናት	ʔabɨ ħɨlufɨ ʔɨwanat	adv
forty	ኣርባዓ	ʔarɨbaʕa	noun
fourteen	ዓሰርተ ኣርባዕተ	ʕasərɨtə ʔarɨbaʕɨtə	noun
fourth grade	ራብዓይ ክፍሊ	rabɨʕajɨ kɨfɨli	noun
free	ነጻ	nət͡sʼa	adj
friend	ብጸይቲ	bɨt͡sʼəjɨti	noun
friendly	ዓላ	ʕala	adj
frog	እንቁሮያብ	ʔɨnɨqurojab	noun
front of a building	ቅድሚ ገዛ	qɨdɨmi ɡəza	noun
frost	ኣስሓይታ	ʔasɨħajɨta	noun
fruit	ፍሩታ	fɨruta	noun
fruit tree	ተኽሊ ፍረ	təxɨli fɨrə	noun
frying	ቅልዋ	qɨlɨwa	noun
full	ጸገበ	t͡sʼəɡəbə	verb
fur	ቆርበት ዘይተመልጠ	qorɨbətɨ zəjɨtəməlɨtʼə	noun
furious	ሓራቖ	ħaraqʰo	adj
furnace	ፎርነሎ	forɨnəlo	noun
furnish	በቑሑ	bəqʰuħu	verb
furniture	ኣቕሓ ገዛ	ʔaqʰɨħa ɡəza	noun
game of chance	ምጥላዕ	mɨtʼɨlaʕ	noun
garlic	ጻዕዳ ሽጉርቲ	t͡sʼaʕɨda ʃɨɡurɨti	noun
gather	ቀውዐ	qəwɨʕə	verb
gather	ጎጅለ	ɡod͡ʒɨlə	verb
gather honey	ማዓር ኣከበ	maʕarɨ ʔakəbə	verb
generosity	ልውህና	lɨwɨhɨna	noun
geography	ጆግራፍ	d͡ʒoɡɨraf	noun
geometry	ጆመትሪ	d͡ʒomətɨri	noun
germinate	በቖለ	bəqʰolə	verb
gesture	ወስታ	wəsɨta	noun
get	ኣልመደ	ʔalɨmədə	verb
get a divorce	ተፋትሐ ሓዳር	təfatɨħə ħadar	verb
get annoyed	ኮረየ	korəjə	verb
get engaged to	ተሓጸየ	təħat͡sʼəjə	verb
get impatient	ተሃንጠየ	təhanɨtʼəjə	verb
get up	ተንሰአ	tənɨsəʔə	verb
get up	እንደገና ተንሰአ	ʔɨnɨdəɡəna tənɨsəʔə	verb
get used to	ኣልመደ	ʔalɨmədə	verb
give an airing	ኣናፈሰ	ʔanafəsə	verb
give birth	ሓረሰት	ħarəsət	verb
give the cold	ተኾርነፈ	təxorɨnəfə	verb
give up	ብፍቓዱ ገደፈ	bɨfɨqʰadu ɡədəfə	verb
give up	ኮነነ	konənə	verb
gladly	ብታሕጓስ	bɨtaħɨɡʷas	adv
glassmaker	ሰራሕ መስኮት	səraħɨ məsɨkot	noun
glove	ግዋንቲ	ɡɨwanɨti	noun
go away	ረሓቐ	rəħaqʰə	verb
go back	ተመለሰ	təmələsə	verb
go	ኣብ ኣገልግሎት ወዓለ	ʔabɨ ʔaɡəlɨɡɨlotɨ wəʕalə	verb
goat	ወጠጦ	wətʼətʼo	noun
goat	ጤል	tʼel	noun
godchild	ጓል ብልግና	ɡʷalɨ bɨlɨɡɨna	noun
godfather	ኣባሊገ	ʔabaliɡə	noun
godmother	ኣባሊገ	ʔabaliɡə	noun
godson	ወዲ ብልግና	wədi bɨlɨɡɨna	noun
good	ከመይ ሓዲርኩም	kəməjɨ ħadirɨkum	noun
good	ከመይ ዊዕልኩም	kəməjɨ wiʕɨlɨkum	noun
good	ደሓን	dəħan	adj
good evening	ከመይ ኣምሲኩም	kəməjɨ ʔamɨsikum	noun
goodnight	ደሓን ሕደር	dəħanɨ ħɨdər	other
goodwill	ጽቡቕ ድሌት	t͡sʼɨbuqʰɨ dɨlet	noun
goose	ዓዓ	ʕaʕa	noun
gorge	ስንጥሮ	sɨnɨtʼɨro	noun
grain	ቅርኒብ እኽሊ	qɨrɨnibɨ ʔɨxɨli	noun
grammar	ስዋስዉ	sɨwasɨwu	noun
granary	መኽዘን ኽፍሊ	məxɨzənɨ xɨfɨli	noun
grand father	ኣቦሓጎ	ʔaboħaɡo	noun
grandfather	ኣባ ሕጎ	ʔaba ħɨɡo	noun
grandmother	ኣደ ዓባይ	ʔadə ʕabaj	noun
grandson	ወዲ ወዲ	wədi wədi	noun
grandson	ወዲ ጓል	wədi ɡʷal	noun
granite	ጸሊም እምኒ	t͡sʼəlimɨ ʔɨmɨni	noun
grape	ወይኒ	wəjɨni	noun
grass plot	ሻኻ	ʃaxa	noun
grave	ዕተብ	ʕɨtəb	adj
grave-digger	ኳዓታይ	kʷaʕataj	noun
graze	ሳዕሪ በልዐ	saʕɨri bəlɨʕə	verb
grazing	ሳዕሪ ምብላዕ	saʕɨri mɨbɨlaʕ	noun
great	ዓብዪ	ʕabɨji	adj
great	ዓብይ	ʕabɨj	adj
green beans	ፋጆሊ	fad͡ʒoli	noun
green mustard	ሐምሊ ኣድሪ	ħəmɨli ʔadɨri	noun
green onion	ዝቢኢ ሹጉርቲ	zɨbiʔi ʃuɡurɨti	noun
green pepper	ፐፐሮኒ	pəpəroni	noun
greenery	ለምዒ	ləmɨʕi	noun
grenade	ደማሚት	dəmamit	noun
grey	ሕሙኽሽታይ	ħɨmuxɨʃɨtaj	adj
grind	ጠሓነ	tʼəħanə	verb
grit	ጭንጫ	t͡ʃʼɨnɨt͡ʃʼa	noun
groan	ተኣነነ	təʔanənə	verb
grocer	በዓልቲ ድኳን	bəʕalɨti dɨkʷan	noun
grocery	ኣሽባሸ	ʔaʃɨbaʃə	noun
ground	ጎልጉል	ɡolɨɡul	noun
group	ጎጅለ	ɡod͡ʒɨlə	verb
grow old	ኣረገ	ʔarəɡə	verb
growing	ዘራእቲ	zəraʔɨti	noun
guardian	ሞጉዚት	moɡuzit	noun
guest	ዕዲም	ʕɨdim	noun
gully	ስንጥሮ	sɨnɨtʼɨro	noun
gums	ግርጻን	ɡɨrɨt͡sʼan	noun
gymnastics	ምንቅስቓስ ኣካላት	mɨnɨqɨsɨqʰasɨ ʔakalat	noun
hair	ጨጉሪ	t͡ʃʼəɡuri	noun
hair	ጽጉሪ ርእሲ	t͡sʼɨɡuri rɨʔɨsi	noun
hairdresser	ቀምቃሚ	qəmɨqami	noun
hand	ኡድ	ʔud	noun
handkerchief	መንዲል	mənɨdil	noun
handshake	ሰላምታ ኢድ	səlamɨta ʔid	noun
hard	ኣጨናቒ	ʔat͡ʃʼənaqʰi	adj
hare	ማንቲለ በረኻ	manɨtilə bərəxa	noun
harmless	ዘይጎድእ	zəjɨɡodɨʔ	adj
harsh	ኣረመና	ʔarəməna	adj
harvest	ቀውዐ	qəwɨʕə	verb
harvest	እኽሊ ኣኸበ	ʔɨxɨli ʔaxəbə	verb
harvester	ቀውዓይ	qəwɨʕaj	noun
hasten	ቐሌጠፈ	qʰəletʼəfə	verb
hat	ቆቢዕ	qobiʕ	noun
have	ተሻቐለ	təʃaqʰələ	verb
have a good time	ተዘናገዐ	təzənaɡəʕə	verb
hawthorn	ቆትቋጥ	qotɨqʷatʼ	noun
hazy	ግማዊ	ɡɨmawi	adj
head	ኣስራሒት	ʔasɨraħit	noun
head-master	አማሓዳሪ	ʔəmaħadari	noun
head-master	ዳይረክቶር	dajɨrəkɨtor	noun
health	ስነ ጥዕና	sɨnə tʼɨʕɨna	noun
hear	ሰመዐ	səməʕə	verb
hearer	ሰማያ	səmaja	noun
hearer	ሰማያት	səmajat	noun
heat	ምዉቕ ስምዒት	mɨwuqʰɨ sɨmɨʕit	noun
heat	ኣውዓየ	ʔawɨʕajə	verb
heat	ኣውዓየ	ʔawɨʕajə	verb
heating	መውዓይ	məwɨʕaj	noun
heavenly	ገነታዊ	ɡənətawi	adj
heel	ሸኾና እግሪ	ʃəxona ʔɨɡɨri	noun
heel	ታኮ	tako	noun
heels	ኩሩኹሮ	kuruxuro	noun
hello	ከመይ ሓዲርኩም	kəməjɨ ħadirɨkum	noun
hello	ከመይ ዊዕልኩም	kəməjɨ wiʕɨlɨkum	noun
helmet	ቆቢዕ ወታሃደር	qobiʕɨ wətahadər	noun
helmet	ጥርቡሽ	tʼɨrɨbuʃ	noun
henhouse	መራብሒ ደርሁ	mərabɨħi dərɨhu	noun
herd	መጓሰ	məɡʷasə	noun
hero	ጀግና	d͡ʒəɡɨna	noun
heroic	ጀግና	d͡ʒəɡɨna	noun
heroine	ቀንዲ ተዋሳኢት	qənɨdi təwasaʔit	noun
heroine	ጀግና ጓል	d͡ʒəɡɨna ɡʷal	noun
hide	ሐብአ	ħəbɨʔə	verb
hide	ሰተረ	sətərə	verb
higher	ላዕላይ	laʕɨlaj	adj
hilly	ጎባዊ	ɡobawi	adj
hip	ምሕኩልቲ	mɨħɨkulɨti	noun
history	ታረኸ	tarəxə	noun
hold up	ደንጎየ	dənɨɡojə	verb
hole	ነኳል	nəkʷal	noun
hollow	ነኳል	nəkʷal	noun
honey	ማዓር	maʕar	noun
honey wine	ሜስ	mes	noun
hook	መጀለቢ	məd͡ʒələbi	noun
hope for	ተተስፈየ	tətəsɨfəjə	verb
horizontal	ግድሞ	ɡɨdɨmo	adj
horrible	ኣሰንባዲ	ʔasənɨbadi	adj
horsemanship	ፈረስ ምስቃል	fərəsɨ mɨsɨqal	noun
host	ተቐባል ጋሻ	təqʰəbalɨ ɡaʃa	noun
house	ርሻን	rɨʃan	noun
house	ቤተ	betə	noun
how much	ክንደይ	kɨnɨdəj	adv
however	ግና	ɡɨna	conj
howl	ገዓረ	ɡəʕarə	verb
humiliate	ኣቋናጸበ	ʔaqʷanat͡sʼəbə	verb
hump	መንዳዓት	mənɨdaʕat	noun
hundred kilos	ኩንታል	kunɨtal	noun
hygiene	ስነ ጥዕና	sɨnə tʼɨʕɨna	noun
ignore	ሻላ በለ	ʃala bələ	verb
illuminate	ኣብረሀ	ʔabɨrəhə	verb
immediately	ብኡንቡኡ	bɨʔunɨbuʔu	adv
impatience	ዘይትዕግስቲ	zəjɨtɨʕɨɡɨsɨti	noun
impossibility	ዘይካኣልነት	zəjɨkaʔalɨnət	noun
impossible	ዘይካኣል	zəjɨkaʔal	adj
in	ኣቐዲምካ ዝግበር	ʔaqʰədimɨka zɨɡɨbər	adj
in front	ብቕድሚ	bɨqʰɨdɨmi	adv
inconvenience	ጸገመ	t͡sʼəɡəmə	verb
independence	ነጻነት	nət͡sʼanət	noun
independent	ነጻ	nət͡sʼa	adj
indigestion	ዘይሕቀት መግቢ	zəjɨħɨqətɨ məɡɨbi	noun
industrial	ኡንዱስትሪያዋ	ʔunɨdusɨtɨrijawa	adj
industrial area	ዞባ ቤት ዕዮታት	zoba betɨ ʕɨjotat	adj
industrialist	ኡንዱስትሪ	ʔunɨdusɨtɨri	noun
inevitable	ዘይተርፍ	zəjɨtərɨf	adj
infancy	ሕጻንነት	ħɨt͡sʼanɨnət	verb
infant	ሕጻን	ħɨt͡sʼan	noun
infant	ቆልዓ	qolɨʕa	noun
infantile	ናይ ሕጻን	najɨ ħɨt͡sʼan	adj
inferior	ታሕታይ	taħɨtaj	adj
infinite	ወሰን ዘአይብሉ	wəsənɨ zəʔəjɨbɨlu	noun
ingratitude	ዘይምምስጋን	zəjɨmɨmɨsɨɡan	noun
inhabitant	ተቐማጢት	təqʰəmatʼit	noun
injury	መቑሰልቲ	məqʰusəlɨti	noun
ink-well	ጥርሙዝ ቀለም	tʼɨrɨmuzɨ qələm	noun
innocent	ንጽህ	nɨt͡sʼɨh	adj
insoluble	ዘይፍታሕ	zəjɨfɨtaħ	adj
installation	ምምዕርራይ ኣቑሑ	mɨmɨʕɨrɨrajɨ ʔaqʰuħu	noun
instrument	መሳርሒ ኣቕሓ	məsarɨħi ʔaqʰɨħa	noun
instrumental	መሳርያዊ ሙዚቃ	məsarɨjawi muziqa	adj
insult	ጸረፈ	t͡sʼərəfə	verb
interest	ወለድ	wələd	noun
ironing	እስትራረ	ʔɨsɨtɨrarə	noun
irrational	ጽልልቲ	t͡sʼɨlɨlɨti	adj
irrigate	መስኖወ	məsɨnowə	verb
ivy	ኣይቢ ዓይነት ሓረግ	ʔajɨbi ʕajɨnətɨ ħarəɡ	noun
jalapeño	ጒዕ	ɡʷiʕ	noun
jaw	መንጋጋ	mənɨɡaɡa	noun
jealous	ቀናአ	qənaʔə	adj
judge	ዓራቒት ፈራዲት	ʕaraqʰitɨ fəradit	noun
judge	ዓራቓይ	ʕaraqʰaj	noun
judge	ፈራዳይ	fəradaj	noun
juicy	ፈሳሲ ዘለዎ	fəsasi zələwo	adj
junior high	ማእከላይ ደረጃ	maʔɨkəlajɨ dərəd͡ʒa	noun
justify	መግለጺ ሃበ	məɡɨlət͡sʼi habə	verb
kennel	ገዛ ኸልቢ	ɡəza xəlɨbi	noun
kidney	ኩሊት	kulit	noun
kidney	ኩላሊት	kulalit	noun
kilogram	ኪሎግራም	kiloɡɨram	noun
kindergarten	መውዓል ህጻናት	məwɨʕalɨ hɨt͡sʼanat	noun
kindness	ለውሃት	ləwɨhat	noun
kitten	ውላድ ድሙ	wɨladɨ dɨmu	noun
knitting	ኡንቺነቶ	ʔunɨt͡ʃinəto	noun
knitwear	ኡንቺነቶ	ʔunɨt͡ʃinəto	noun
knot	ቁጻር	qut͡sʼar	noun
lack	ጉዳል	ɡudal	noun
lake	ቀላያዊ	qəlajawi	adj
lampshade	ገራድ ብርሃን	ɡəradɨ bɨrɨhan	noun
landscape	ገጽ መሬት	ɡət͡sʼɨ məret	noun
language	ቛንቛ	qʰʷanɨqʰʷa	noun
large	ረጉድ	rəɡud	adj
large	ዓብዪ	ʕabɨji	adj
large	ዓብይ	ʕabɨj	adj
latecomer	ደንጓዩ	dənɨɡʷaju	noun
laugh at	ተላገጸ	təlaɡət͡sʼə	verb
laughter	ሳሓቕ	saħaqʰ	noun
lavatory	መሕጸቢ ቤት	məħɨt͡sʼəbi bet	noun
lavatory	ሽንቲ ቤት	ʃɨnɨti bet	noun
lay	ሰጥሐ	sətʼɨħə	verb
lazy	ህኩይ	hɨkuj	adj
lead	ኣምረሐ	ʔamɨrəħə	verb
leaf	ፎልዮ	folɨjo	noun
left	ጸጋም	t͡sʼəɡam	noun
leg	መሓውር እንስሳ	məħawɨrɨ ʔɨnɨsɨsa	noun
leg	ሰለፍ	sələf	noun
legend	ኣፈ ታሪኽ	ʔafə tarix	noun
legs/leg muscles	ሙሕኹልቲ	muħɨxulɨti	noun
lemon-tree	ገረብ ለሚን	ɡərəbɨ ləmin	noun
lend	ኣለቀሐ	ʔaləqəħə	verb
lend	ኣሰቅሐ	ʔasəqɨħə	verb
lentils	ብርስን	bɨrɨsɨn	noun
lesson	መጽናዕቲ ትምህርቲ	mət͡sʼɨnaʕɨti tɨmɨhɨrɨti	noun
letter	ደብዳቤ	dəbɨdabe	noun
letter-box	ቦስጣ ሳጹን	bosɨtʼa sat͡sʼun	noun
lettuce	ሳላጣ	salatʼa	noun
level	ኣጽፈሐ	ʔat͡sʼɨfəħə	verb
liberal	ሰፊሕ ሓሳብ	səfiħɨ ħasab	adj
library	ቤተ ንባብ	betə nɨbab	noun
lid	መኽደኒ ድስቲ	məxɨdəni dɨsɨti	noun
light	ብራሃን	bɨrahan	noun
light	ኣብረሀ	ʔabɨrəhə	verb
light up	ወለዐ	wələʕə	verb
likable	ፍሕሽው	fɨħɨʃɨw	adj
lining	ፎደራ	fodəra	noun
link	እላም	ʔɨlam	noun
lioness	ኣንበሲት	ʔanɨbəsit	noun
listener	ሰማያ	səmaja	noun
listener	ሰማያት	səmajat	noun
literature	ስነ ጽሑፋ	sɨnə t͡sʼɨħufa	noun
litre	ሊተር	litər	noun
little	ንእሽተይ	nɨʔɨʃɨtəj	adj
liveliness	ዓላነት	ʕalanət	noun
liver	ጸላም አብዲ	t͡sʼəlamɨ ʔəbɨdi	noun
living	መዕረፊ ክፍሊ	məʕɨrəfi kɨfɨli	noun
lizard	ጠበቕ	tʼəbəqʰ	noun
loan	ኣለቀሐ	ʔaləqəħə	verb
lock	መሽገጥ	məʃɨɡətʼ	noun
lock	ሰጋጥ	səɡatʼ	noun
locust	ሕንጉጉ	ħɨnɨɡuɡu	noun
loneliness	ጽምዋ	t͡sʼɨmɨwa	noun
loneliness	ብሕትውና	bɨħɨtɨwɨna	noun
lonely	ጽምው	t͡sʼɨmɨw	adj
long	ነዊሕ ግዜ	nəwiħɨ ɡɨze	adv
look	ወዝ	wəz	noun
lord	ጎይታ	ɡojɨta	noun
lorry	መኪና ጽዕነት	məkina t͡sʼɨʕɨnət	noun
lose	ተሳዓረ	təsaʕarə	verb
loud	ጫውጫውታ ዘለዎ	t͡ʃʼawɨt͡ʃʼawɨta zələwo	adj
lounge	መዕረፊ ክፍሊ	məʕɨrəfi kɨfɨli	noun
luggage	ኣቑሑ ጉዕዞ	ʔaqʰuħu ɡuʕɨzo	noun
luxury	ጣዐሚ	tʼaʕəmi	noun
machine gun	ማሺን ጋን	maʃinɨ ɡan	noun
mail	ቡስጣ ቤት	busɨtʼa bet	noun
mail	ደብዳቤ	dəbɨdabe	noun
maize	ዑፉን	ʕufun	noun
majesty	ጃንሆይ	d͡ʒanɨhoj	noun
major	ዝኣኸለ	zɨʔaxələ	adj
majority	ብዙሓን	bɨzuħan	noun
make a hole	ኣንኮለ	ʔanɨkolə	verb
make fun of	ማስየ	masɨjə	verb
make fun of	ተላገጸ	təlaɡət͡sʼə	verb
make up	ፊደላት ሰርዐ	fidəlatɨ sərɨʕə	verb
malice	ርግመት	rɨɡɨmət	noun
malicious	ሃሳይ	hasaj	adj
manage	ኣመሓደረ	ʔaməħadərə	verb
manage	ኣምሓደረ	ʔamɨħadərə	verb
manual	ሞያዊ መጽሓፍ	mojawi mət͡sʼɨħaf	adj
manufacture	ጸብጻብ ዕዳ	t͡sʼəbɨt͡sʼabɨ ʕɨda	noun
many	ክሳብ ክንድኡ	kɨsabɨ kɨnɨdɨʔu	adv
marble	ባሊና	balina	noun
marble	እምነ በረድ	ʔɨmɨnə bərəd	noun
mare	ባዝራ	bazɨra	noun
marine	ባሕራዊ	baħɨrawi	adj
marmot	ማርሞት	marɨmot	noun
marry off	ምርዕው	mɨrɨʕɨw	verb
marry off	ኣመርዓወ	ʔamərɨʕawə	verb
martyr	ሰማእት	səmaʔɨt	noun
mate	ብጸይቲ	bɨt͡sʼəjɨti	noun
material	ኣቑሑ ህንጻ	ʔaqʰuħu hɨnɨt͡sʼa	noun
maternal	ኣደታዊ	ʔadətawi	adj
math	ኩጽሪ	kut͡sʼɨri	noun
maturity	ብስለት	bɨsɨlət	noun
me	ኣነ	ʔanə	pron
mead	ሜስ	mes	noun
meanness	እኩይነት	ʔɨkujɨnət	noun
melting	ምሕቃቐ	mɨħɨqaqʰə	noun
mercury	ባዜቃ	bazeqa	noun
meteorology	ስነ ኣየር	sɨnə ʔajər	noun
meter	ቆጻሪ	qot͡sʼari	noun
method	ቀጥዒ	qətʼɨʕi	noun
military	ወተሃበራዊ	wətəhabərawi	adj
milk-man	በዓል ጸባ	bəʕalɨ t͡sʼəba	noun
milk-woman	በዓልቲ ጸባ	bəʕalɨti t͡sʼəba	noun
mill	ጠሓኒት	tʼəħanit	noun
miller	ጠሓኒ	tʼəħani	noun
millimetre	ሚሊ ሜተር	mili metər	noun
minor	ትሑት ቃና	tɨħutɨ qana	adj
minor	ንእሽተይ	nɨʔɨʃɨtəj	adj
minor	ዘይብጹሕ	zəjɨbɨt͡sʼuħ	noun
minor	ፈሓር ማዕድን	fəħarɨ maʕɨdɨn	noun
miracle	ትኣምር	tɨʔamɨr	noun
miserable	ከርፋሕ	kərɨfaħ	adj
misfortune	ቅርሳሰ	qɨrɨsasə	noun
missionary	ሰባኺ	səbaxi	noun
mistletoe	ሚሰልቶ ተኽሊ	misəlɨto təxɨli	noun
mode of transport	መጓዓዝያ	məɡʷaʕazɨja	noun
model 	ንድፋዊ ምስሊ	nɨdɨfawi mɨsɨli	noun
momentary	ግዚያዊ	ɡɨzijawi	adj
mood	ኩነት ኣእምር	kunətɨ ʔaʔɨmɨr	noun
moral	ሞራል	moral	noun
morning	ናይ ንጉሆ	najɨ nɨɡuho	adj
morning	ንጉሆ	nɨɡuho	noun
mother	ኣደታዊ	ʔadətawi	adj
motor	ሞተር	motər	noun
motorbike	ሞቶ	moto	noun
mountaineering	ምድያብ	mɨdɨjab	noun
mountainous	ጎባዊ	ɡobawi	adj
move	ቦታ ቀየረ	bota qəjərə	verb
move	ኣንቀሳቀሰ	ʔanɨqəsaqəsə	verb
move	ኣንቅሳቐሰ	ʔanɨqɨsaqʰəsə	verb
move away	ረሓቐ	rəħaqʰə	verb
muddy	ዝጨቀወ	zɨt͡ʃʼəqəwə	adj
mule	በቕሊ	bəqʰɨli	noun
multiply	ኣርሰሐ	ʔarɨsəħə	verb
mumps	ጽጌዕ	t͡sʼɨɡeʕ	noun
municipal	ናይ መዘጋጃ ቤተ	najɨ məzəɡad͡ʒa betə	adj
museum	ቤተ መዘከር	betə məzəkər	noun
mutton	ስጋ በጊዕ	sɨɡa bəɡiʕ	noun
muzzle	ኣፍን ኣፍንጫን እንስሳ	ʔafɨnɨ ʔafɨnɨt͡ʃʼanɨ ʔɨnɨsɨsa	noun
nail-file	መብረድ	məbɨrəd	noun
narrow	ጽቢብ	t͡sʼɨbib	adj
nastiness	ርግመት	rɨɡɨmət	noun
nastiness	እኩይነት	ʔɨkujɨnət	noun
naturalize	ዜግነት ለወጠ	zeɡɨnətɨ ləwətʼə	verb
neighbourhood	ጉርብትና	ɡurɨbɨtɨna	noun
neighbouring	ጎረቤት	ɡorəbet	noun
nephew (brother)	ወዲ ሓዊ	wədi ħawi	noun
nephew (sister)	ወዲ ሓብቲ	wədi ħabɨti	noun
nest	ገዛ ዑፍ	ɡəza ʕuf	noun
nest	ገዛ ዑፍ ሰርሐ	ɡəza ʕufɨ sərɨħə	verb
new year	ሓዲሽ ዓመት	ħadiʃɨ ʕamət	noun
nice	ዓላ	ʕala	adj
niece	ኣጎስማ	ʔaɡosɨma	noun
niece (brother)	ጓል ሓዊ	ɡʷalɨ ħawi	noun
niece (brother)	ጓል ሓው	ɡʷalɨ ħaw	noun
niece (sister)	ጓል ሓብቲ	ɡʷalɨ ħabɨti	noun
nightstand	ኮመዲኖ	komədino	noun
nine	ትሽዓተ	tɨʃɨʕatə	adj
nineteen	ዓሰርተ ትሽዓተ	ʕasərɨtə tɨʃɨʕatə	noun
ninety	ተስዓ	təsɨʕa	noun
ninth grade	ታሽዓይ ክፍሊ	taʃɨʕajɨ kɨfɨli	noun
no	እምቢ	ʔɨmɨbi	adj
nobility	ጎይትነት	ɡojɨtɨnət	noun
noisy	ጫውጫውታ ዘለዎ	t͡ʃʼawɨt͡ʃʼawɨta zələwo	adj
nostril	መሳኹት ኣፍንጫ	məsaxutɨ ʔafɨnɨt͡ʃʼa	noun
nostril	ሰርኖ	sərɨno	noun
note	ነጥቢ ሓዘ	nətʼɨbi ħazə	verb
note down	ነጥቢ ሓዘ	nətʼɨbi ħazə	verb
nothing	ገለኳ	ɡələkʷa	adv
novel	ልብ ወለድ	lɨbɨ wələd	noun
novelist	ተራኺ	təraxi	noun
novelist	ተራኺት	təraxit	noun
now	ድሕሪ ሕጂ	dɨħɨri ħɨd͡ʒi	adv
numerous	ብዙሓት	bɨzuħat	adj
oak	ኦክ	ʔok	noun
oath	ማሕላ	maħɨla	noun
oats	ሳዓዕ	saʕaʕ	noun
obedience	ተኣዛዝነት	təʔazazɨnət	noun
obtuse	ጎዲም	ɡodim	adj
odd	ዘይጽምዲ ቁጽሪ	zəjɨt͡sʼɨmɨdi qut͡sʼɨri	adj
offend	ኣቐየመ	ʔaqʰəjəmə	verb
offer	ቅረባ	qɨrəba	noun
office	ቡስጣ ቤት	busɨtʼa bet	noun
officer	መኮነን	məkonən	noun
often	መብዛሕቱኢ ግዝ	məbɨzaħɨtuʔi ɡɨz	adv
okay	ደሓን	dəħan	adj
old	ዓብዪ	ʕabɨji	adj
old	ዓብይ	ʕabɨj	adj
onion	ሽጉርቲ ቀይሕ	ʃɨɡurɨti qəjɨħ	noun
onlooker	ተዓዛቢት	təʕazabit	noun
only	እንኮ	ʔɨnɨko	adj
opening	ክፋት	kɨfat	noun
operating	ክፍሊ መጥባሕቲ	kɨfɨli mətʼɨbaħɨti	noun
orange	ኣራንሺ	ʔaranɨʃi	noun
orange	ኣራንቺ	ʔaranɨt͡ʃi	adj
orange juice	ጹማቕ አራንቺ	t͡sʼumaqʰɨ ʔəranɨt͡ʃi	noun
orange tree	ገረብ ብርትኳን	ɡərəbɨ bɨrɨtɨkʷan	noun
orchard	ኣጸደ ፍረታት	ʔat͡sʼədə fɨrətat	noun
ordinarily	ልሙዳዊ	lɨmudawi	adv
orphan	ዘኸታም	zəxətam	noun
otherwise	እንተዘይኮነ	ʔɨnɨtəzəjɨkonə	adv
out of tune	ቃና ዘይብሉ	qana zəjɨbɨlu	adj
outside	ድጋዊ	dɨɡawi	adj
outskirts	ጎደቦ	ɡodəbo	noun
oval	ቅርጺ እንቋቒሖ	qɨrɨt͡sʼi ʔɨnɨqʷaqʰiħo	adj
overt	ብፍላጥ	bɨfɨlatʼ	adv
owe	ተኣወደ	təʔawədə	verb
owl	ጉንጓ	ɡunɨɡʷa	noun
owner	ዋና ገዛ	wana ɡəza	noun
ox	ብዕራይ	bɨʕɨraj	noun
package	መጠርነፊ	mətʼərɨnəfi	noun
packet	ባኮ ቡስጣ	bako busɨtʼa	noun
packing	መጠርነፊ	mətʼərɨnəfi	noun
paganism	ኣረማውነት	ʔarəmawɨnət	noun
pail	ሳንኮሎ	sanɨkolo	noun
painter	ለማጻይ	ləmat͡sʼaj	noun
pale	ጨዓይ	t͡ʃʼəʕaj	adj
palette	መዳወሲ ሕብሪ	mədawəsi ħɨbɨri	noun
palm	ከብዲ ኢድ	kəbɨdi ʔid	noun
parade	ተሰሪዑ	təsəriʕu	verb
parent	ወለዲ	wələdi	noun
parish	ቤተ ጸሎት	betə t͡sʼəlot	noun
park	መናፈሻ ቦታ	mənafəʃa bota	noun
park	ጠጠ ኣበለ	tʼətʼə ʔabələ	verb
part	ጨራጽ ጠርቂ	t͡ʃʼərat͡sʼɨ tʼərɨqi	noun
part of a house	ከፍሊ ገዛ	kəfɨli ɡəza	noun
participate	ተሳዓፈ	təsaʕafə	verb
partridge	ቆቕሕ	qoqʰɨħ	noun
party	ፖለቲካዊ ሰልፊ	polətikawi səlɨfi	noun
passage	ኮረደዮ	korədəjo	noun
passed	ሓሊፈ	ħalifə	adj
paste	ቢሑቕ	biħuqʰ	noun
paste	ባስታ	basɨta	noun
pastry	እንዳ ዶልሺ	ʔɨnɨda dolɨʃi	noun
pastry	እንዳ ዶልሺ	ʔɨnɨda dolɨʃi	noun
patch	ለገበ	ləɡəbə	verb
paternal	ኣብታዊ	ʔabɨtawi	adj
patient	ተሓካሚ	təħakami	noun
pattern	ንድፋዊ ምስሊ	nɨdɨfawi mɨsɨli	noun
pay	ከፈአ	kəfəʔə	verb
pay off	ኪኸፍል	kixəfɨl	verb
peace	ቅሳነተ	qɨsanətə	noun
peach	ምግፋእ	mɨɡɨfaʔ	noun
peach	ኩኽ	kux	noun
peanuts	ፉል	ful	noun
pear	ፐረ	pərə	noun
pear tree	ፐረ	pərə	noun
pearl	ዕንቍ	ʕɨnɨqʷ	noun
peasant	ዓኳይ	ʕakʷaj	noun
pelt	ቆርበት ዘይተመልጠ	qorɨbətɨ zəjɨtəməlɨtʼə	noun
penal	ገበናዊ	ɡəbənawi	adj
pendulum clock	ሰዓት መንደቕ	səʕatɨ mənɨdəqʰ	noun
penetrate	ሰረጸ	sərət͡sʼə	verb
perch	ተወጠሐ	təwətʼəħə	verb
perform	ፈጽመ	fət͡sʼɨmə	verb
perform	ተጻወተ ምዚቃ	tət͡sʼawətə mɨziqa	verb
performance	ሙዚቃዊ ጸወታ	muziqawi t͡sʼəwəta	noun
perspire	ረሃጸ	rəhat͡sʼə	verb
persuade	ኣእመነ	ʔaʔɨmənə	verb
pharmacist	ፋርማሲያዊ	farɨmasijawi	noun
pharmacy	ፋርማሲ	farɨmasi	noun
pheasant	ዛግራ	zaɡɨra	noun
phone booth	ክፍሊ ተለፎን	kɨfɨli tələfon	noun
physics	ፈልደት	fəlɨdət	noun
pick-axe	ኣፍራዛ	ʔafɨraza	noun
picking	እርያ ፍረታት	ʔɨrɨja fɨrətat	noun
piece	ጨራጽ ጠርቂ	t͡ʃʼərat͡sʼɨ tʼərɨqi	noun
pig farm	መራብሒ ሓሰማ	mərabɨħi ħasəma	noun
pigeon	ርግቢ	rɨɡɨbi	noun
pilgrimage	ንግደት	nɨɡɨdət	noun
place	ትቕመጠሉ ቦታ	tɨqʰɨmətʼəlu bota	noun
place/something	መስቀል ስእሊ	məsɨqəlɨ sɨʔɨli	noun
plainly	ጽሩይ ውጹእ	t͡sʼɨrujɨ wɨt͡sʼuʔ	adj
plank	መንደቒ ኡሕ	mənɨdəqʰi ʔuħ	noun
plaque	ንእሽተይ ሰልዳ	nɨʔɨʃɨtəjɨ səlɨda	noun
plateau	ጓንተራ	ɡʷanɨtəra	noun
platform	መድረክ	mədɨrək	noun
play	ጻውቲ	t͡sʼawɨti	verb
player	ተጻዋቲት	tət͡sʼawatit	noun
pleasant	ፍሕሽው	fɨħɨʃɨw	adj
please	ብኽብረትኩም	bɨxɨbɨrətɨkum	adv
plumber	ሰራሕ ቱቦ ማይ	səraħɨ tubo maj	noun
poet	ተቐናይ	təqʰənaj	noun
politician	ፖለቲክ	polətik	noun
pomp	ፖምፓ	pomɨpa	noun
portfolio	እንዳ ገንዘብ	ʔɨnɨda ɡənɨzəb	noun
possible	ዝከኣል	zɨkəʔal	adj
post	ቡስጣ ቤት	busɨtʼa bet	noun
post card	ካርቶሊና	karɨtolina	noun
post office	ቦስጣ ቤት	bosɨtʼa bet	noun
postal	ብቦስጣ	bɨbosɨtʼa	adj
pot	መቕድሒ ፈሳሲ	məqʰɨdɨħi fəsasi	noun
pot	ጻሕሊ	t͡sʼaħɨli	noun
pound	ፍርቂ ኪሎ	fɨrɨqi kilo	noun
pour out	ቐድሐ	qʰədɨħə	verb
practice	ዝዉተራ	zɨwutəra	noun
praise	መጎስ	məɡos	noun
prayer	ጸሉት	t͡sʼəlut	noun
preach	ሰበኸ	səbəxə	verb
preparation	ቅርርብ	qɨrɨrɨb	noun
presence	ህላዌ	hɨlawe	noun
president	ኣቦ መንበር	ʔabo mənɨbər	noun
press	ማዕከን ወረ	maʕɨkənɨ wərə	noun
press	ጸማቊት	t͡sʼəmaqʷit	noun
press	ጸሞቐ	t͡sʼəmoqʰə	verb
press	ጽቓጢት	t͡sʼɨqʰatʼit	noun
press release	ጋዜጣዊ መግለጺ	ɡazetʼawi məɡɨlət͡sʼi	noun
prey	ተሃዳኒ	təhadani	noun
prick	ሸቅታ	ʃəqɨta	noun
prickly	ኣሻኹ	ʔaʃaxu	adj
printers	ቤተ ማሕተም	betə maħɨtəm	noun
prison	ቤተ ማሕቡስ	betə maħɨbus	noun
proceed	ንቕድሚት ኣምረሐ	nɨqʰɨdɨmitɨ ʔamɨrəħə	verb
profession	ናይ ስራሕ ክእለት	najɨ sɨraħɨ kɨʔɨlət	noun
profitable	ረብሓ ዘለዎ	rəbɨħa zələwo	adj
promise	ተመባጸዐ	təməbat͡sʼəʕə	verb
promise	ተመባጽዓ	təməbat͡sʼɨʕa	verb
promote	ኣዛዘወ	ʔazazəwə	verb
prose	ስዲ ንባብ	sɨdi nɨbab	noun
protect	ተኸላኸከ	təxəlaxəkə	verb
protection	ጸገዒ	t͡sʼəɡəʕi	noun
proud	ትዕቢተኛ	tɨʕɨbitəɲa	adj
proudly	ብኹርዓት	bɨxurɨʕat	adv
prove	መርትያ ኣቕረበ	mərɨtɨja ʔaqʰɨrəbə	verb
provoke	ተኹተኸ	təxutəxə	verb
puddle	ዕቋር ማይ	ʕɨqʷarɨ maj	noun
punch	ዕምኮ	ʕɨmɨko	noun
punish	ቐጽዐ	qʰət͡sʼɨʕə	verb
pupil	ተማሃሪት	təmaharit	noun
purify	ኣንአሀ	ʔanɨʔəhə	verb
purr	ሩር በለ	rurɨ bələ	verb
put shoes on	ሳእኒ ለበሰ	saʔɨni ləbəsə	verb
put up	ዓለመ	ʕaləmə	verb
quarter	ርብዒ	rɨbɨʕi	noun
quickly	ብቑልጡፍ	bɨqʰulɨtʼuf	adv
rabbit hole	ጉድጓድ ውኻርዋያ	ɡudɨɡʷadɨ wɨxarɨwaja	noun
rabbit hutch	ገዛ ማንቲለ	ɡəza manɨtilə	noun
race	ቅድድም	qɨdɨdɨm	noun
race	ጎየየ	ɡojəjə	verb
radio	ራዲዮ	radijo	noun
rage	ቁጠዓ	qutʼəʕa	noun
rainbow	ቀስተ ደመና	qəsɨtə dəməna	noun
rainy	ዝናባዊ	zɨnabawi	adj
rake	ሓግሓገ	ħaɡɨħaɡə	verb
range	መስመራት	məsɨmərat	noun
ravine	ስንጥሮ	sɨnɨtʼɨro	noun
read	ነበበ	nəbəbə	verb
read	እንደገና ኣንበበ	ʔɨnɨdəɡəna ʔanɨbəbə	verb
read again	እንደገና ኣንበበ	ʔɨnɨdəɡəna ʔanɨbəbə	verb
reader	ኣንባቢት	ʔanɨbabit	noun
reading	ንባብ	nɨbab	noun
realize	ተአንዘበ	təʔənɨzəbə	verb
reap	እኽሊ ኣኸበ	ʔɨxɨli ʔaxəbə	verb
reassure	ኣተኣማመነ	ʔatəʔamamənə	verb
receipt	ቅብሊት	qɨbɨlit	noun
reception	ኣቀባብላ	ʔaqəbabɨla	noun
reception	መቐበል ጋሻ	məqʰəbəlɨ ɡaʃa	noun
reclaim	ቆጥቆጠ	qotʼɨqotʼə	verb
reclimb	እንደገና ደየበ	ʔɨnɨdəɡəna dəjəbə	verb
recommend	ተላበወ	təlabəwə	verb
recover	ረኸቦ	rəxəbo	verb
recover	እንደና ረኸበ	ʔɨnɨdəna rəxəbə	verb
recover	ጠዓየ	tʼəʕajə	verb
rectangle	ርቡዕ ኩርናዕ	rɨbuʕɨ kurɨnaʕ	noun
red	ቀይሕ ጸጉሩ	qəjɨħɨ t͡sʼəɡuru	adj
reddish	ቀይሕ ጸጉሩ	qəjɨħɨ t͡sʼəɡuru	adj
reduce	ኣጕደለ	ʔaɡʷɨdələ	verb
reed	ስንስላ	sɨnɨsɨla	noun
refuge	ምንስሓብ	mɨnɨsɨħab	noun
refusal	እምቢታ	ʔɨmɨbita	noun
refuse	ኣብየ	ʔabɨjə	verb
regain	እንደና ረኸበ	ʔɨnɨdəna rəxəbə	verb
regiment	ረጂመንት	rəd͡ʒimənɨt	noun
regularly	ብስሩዕነት	bɨsɨruʕɨnət	adv
regulate	ስርዓት ኣትሓዘ	sɨrɨʕatɨ ʔatɨħazə	verb
relate	ተረተ	tərətə	verb
relation	ፈለጥቲ	fələtʼɨti	noun
relationship	ፈለጥቲ	fələtʼɨti	noun
relative	ወለዲ	wələdi	noun
relieve	ኣፋኾሰ	ʔafaxosə	verb
remain	ጽንሐ	t͡sʼɨnɨħə	verb
remainder	ተረፍ መግቢ	tərəfɨ məɡɨbi	noun
remark	ብህሊት	bɨhɨlit	noun
renew	ኣሐደሰ	ʔaħədəsə	verb
rent	ተኸረየ	təxərəjə	verb
repent	ተጣዓሰ	tətʼaʕasə	verb
reply	ምላሽ ሃበ	mɨlaʃɨ habə	verb
reproach	ወቕሳ	wəqʰɨsa	noun
republic	ሩፑብሊክ	rupubɨlik	noun
rescuer	መድሓኒ	mədɨħani	noun
reservation	ቅሙጥ	qɨmutʼ	noun
reserve	ቅሙጥ	qɨmutʼ	noun
residence	ትቕመጠሉ ቦታ	tɨqʰɨmətʼəlu bota	noun
resistance	ተቓዉሞ	təqʰawumo	noun
respect	ኣኸበረ	ʔaxəbərə	verb
rest	ተረፍ መግቢ	tərəfɨ məɡɨbi	noun
restart	እንደገና ጀመረ	ʔɨnɨdəɡəna d͡ʒəmərə	verb
restaurant	ቤተ ብልዒ	betə bɨlɨʕi	noun
retirement	ጥሮታ	tʼɨrota	noun
retreat	ምንስሓብ	mɨnɨsɨħab	noun
retreat	ጥሮታ	tʼɨrota	noun
return	ተመለሰ	təmələsə	verb
return	እንደገና መጸ	ʔɨnɨdəɡəna mət͡sʼə	verb
return ticket	ቲከት መምለሲ	tikətɨ məmɨləsi	noun
reveal	ቀልዕ	qəlɨʕ	verb
reverse	ግምጥልሽ	ɡɨmɨtʼɨlɨʃ	noun
revolution	ሰዉራ	səwura	noun
reward	ጻማ ፈደየ	t͡sʼama fədəjə	verb
ribs	መሰናግለ	məsənaɡɨlə	noun
rice	ራይስ	rajɨs	noun
rich person	ብርጅዋ	bɨrɨd͡ʒɨwa	noun
right to vote	መሰል ድምጺ	məsəlɨ dɨmɨt͡sʼi	noun
ring	መቓልሕ ሃበ	məqʰalɨħɨ habə	verb
rise	ተንሰአ	tənɨsəʔə	verb
rise	እንደገና ተንሰአ	ʔɨnɨdəɡəna tənɨsəʔə	verb
risk	ተረከሰ	tərəkəsə	verb
rivet	ጎዲም መስማር	ɡodimɨ məsɨmar	noun
roar	ገዓረ	ɡəʕarə	verb
roast	ጥቡስ ስጋ	tʼɨbusɨ sɨɡa	noun
roofer	ሰራሕ ናሕሲ	səraħɨ naħɨsi	noun
root	ቀይሕ ሱር	qəjɨħɨ sur	noun
rose	ጽጌረዳ	t͡sʼɨɡerəda	noun
rose bush	ገረበ ጽግረዳ	ɡərəbə t͡sʼɨɡɨrəda	noun
rot	መሽመሸ	məʃɨməʃə	verb
rub	ፋሕፈሐ	faħɨfəħə	verb
ruin	ኣባላሸወ	ʔabalaʃəwə	verb
ruler	ደሲ ሚተር	dəsi mitər	noun
ruminate	ኣኮማሰዐ	ʔakomasəʕə	verb
run	ጎየየ	ɡojəjə	verb
run around	ከብከብ በለ	kəbɨkəbɨ bələ	verb
run up	ብታህዋኽ በጽሐ	bɨtahɨwaxɨ bət͡sʼɨħə	verb
runner	ጎያዩ	ɡojaju	noun
rusty	መራት	mərat	adj
sacrament	ቁርባን	qurɨban	noun
sacrifice	ሰዉአ	səwuʔə	verb
sacrifice	ተሰወአ	təsəwəʔə	verb
safety	ክፍሊ ገበን	kɨfɨli ɡəbən	noun
sailing ship	ጋንጽላ መንርከብ	ɡanɨt͡sʼɨla mənɨrɨkəb	noun
salad	ሳላጣ	salatʼa	noun
sardine	ሳርዲን	sarɨdin	noun
satiate	ጸገበ	t͡sʼəɡəbə	verb
satisfy	ኣዐገበ	ʔaʕəɡəbə	verb
saving	ውህላለ ገንዘብ	wɨhɨlalə ɡənɨzəb	noun
saviour	መድሓኒ	mədɨħani	noun
scare	ኣፍረሐ	ʔafɨrəħə	verb
scarf	ሻል	ʃal	noun
school	ቤተ ትምህርቲ	betə tɨmɨhɨrɨti	noun
schoolgirl	ተማሃሪት	təmaharit	noun
science	ሳየንስ	sajənɨs	noun
science	ኣስተዋጽኦ ፍልጠት	ʔasɨtəwat͡sʼɨʔo fɨlɨtʼət	noun
scintillate	በለጥ በለ	bələtʼɨ bələ	verb
scissors	መቐስ	məqʰəs	noun
scissors	መቐዝ	məqʰəz	noun
scour	ፋሕፈሐ	faħɨfəħə	verb
scrape	ፋሕፈሐ	faħɨfəħə	verb
screwdriver	ዘዋር መስኒ	zəwarɨ məsɨni	noun
scrub	ነገፈ	nəɡəfə	verb
seam	ስፍየት ክዳን	sɨfɨjətɨ kɨdan	noun
search	ሃለው በለ	haləwɨ bələ	verb
search	ሓግሓገ	ħaɡɨħaɡə	verb
season	ክፍለ ዓመት	kɨfɨlə ʕamət	noun
second	ሰከንድ	səkənɨd	noun
second grade	ካልኣይ ክፍሊ	kalɨʔajɨ kɨfɨli	noun
secretary	ዋና ጸሓፊ	wana t͡sʼəħafi	noun
secretary	ጸሐፊ	t͡sʼəħəfi	noun
secretary	ጸሓፊት	t͡sʼəħafit	noun
section	ኣቃድዳ	ʔaqadɨda	noun
section	ኣቋራርጻ	ʔaqʷararɨt͡sʼa	noun
security	ክፍሊ ገበን	kɨfɨli ɡəbən	noun
seed	ዘርኢ ለሚን	zərɨʔi ləmin	noun
seesaw	ሰለል	sələl	noun
selfconfidence	መተኣማመኒ	mətəʔamaməni	noun
sell	ሸየጠ	ʃəjətʼə	verb
send	ስደደ	sɨdədə	verb
sentence	ኮነነ	konənə	verb
sergeant	ሰርገንቲ	sərɨɡənɨti	noun
serious	ዕተብ	ʕɨtəb	adj
servant	ኣገልጋሊት	ʔaɡəlɨɡalit	noun
servant	ከዳሚ	kədami	noun
service	ጨንፈር ስራሕ	t͡ʃʼənɨfərɨ sɨraħ	noun
service	ጽቡቕ ግብሪ	t͡sʼɨbuqʰɨ ɡɨbɨri	noun
set up	ኣትከለ	ʔatɨkələ	verb
seventeen	ዓሰርተ ሸውዓተ	ʕasərɨtə ʃəwɨʕatə	noun
seventh grade	ሻቡዓይ ክፍሊ	ʃabuʕajɨ kɨfɨli	noun
seventy	ሰብዓ	səbɨʕa	noun
sewing	ስፍየት ክዳን	sɨfɨjətɨ kɨdan	noun
shake	ሓቖነ	ħaqʰonə	verb
shake	ነቕነቐ	nəqʰɨnəqʰə	verb
shake	ነጽነጸ	nət͡sʼɨnət͡sʼə	verb
shameful	ዘሕፍር	zəħɨfɨr	adj
share	ኣካፈለ	ʔakafələ	verb
sharp	ቀጢን ድምጺ	qətʼinɨ dɨmɨt͡sʼi	noun
sheep	ስጋ በጊዕ	sɨɡa bəɡiʕ	noun
sheep pen	እንዳ ኣባጊዕ	ʔɨnɨda ʔabaɡiʕ	noun
sheet paper	ፎልዮ	folɨjo	noun
shell	ቦምባ ከቢድ ብረት	bomɨba kəbidɨ bɨrət	noun
shelter	መዕቀሊ	məʕɨqəli	noun
shelves	እስካፋለ	ʔɨsɨkafalə	noun
shift	ቦታ ቀየረ	bota qəjərə	verb
shining bright	ኣንጸባረቒ	ʔanɨt͡sʼəbarəqʰi	adj
ship	ባቡር ቀላይ	baburɨ qəlaj	noun
shirt	ካሚሻ	kamiʃa	noun
shoemaker	ሰራሕ ሳእኒ	səraħɨ saʔɨni	noun
shortage	ጉዳል	ɡudal	noun
shower	ዝናብ መሕጸቢ	zɨnabɨ məħɨt͡sʼəbi	noun
shut	ዕጽዉ	ʕɨt͡sʼɨwu	adj
shutter	መጋረጀ	məɡarəd͡ʒə	noun
sigh	ኡፎይታ	ʔufojɨta	noun
sign	ሰሌዳ ምልክት	səleda mɨlɨkɨt	noun
silent	ጸጥተኛ	t͡sʼətʼɨtəɲa	adj
silvery	ብሩር ዝተቀብአ	bɨrurɨ zɨtəqəbɨʔə	adj
similar	ዝመስሰል	zɨməsɨsəl	adj
similar to Butter	ማይ ጨባ	majɨ t͡ʃʼəba	noun
similar to cottage	ኣጁቦ	ʔad͡ʒubo	noun
single	ዘይምርዕዉ	zəjɨmɨrɨʕɨwu	noun
sinus	ስርኖ	sɨrɨno	noun
sister	ሓብቲ	ħabɨti	noun
sit down	ኮፍ በለ	kofɨ bələ	verb
six	ሽዱሽተ	ʃɨduʃɨtə	adj
sixteen	ዓሰርተ ሽዱሽተ	ʕasərɨtə ʃɨduʃɨtə	noun
sixth grade	ሻዱሻይ ክፍሊ	ʃaduʃajɨ kɨfɨli	noun
sixty	ስሳ	sɨsa	noun
sizzle	ጩቕጩቕ በለ	t͡ʃʼuqʰɨt͡ʃʼuqʰɨ bələ	verb
skeleton	ኣስሬን	ʔasɨren	noun
skilful person	ሊቕ	liqʰ	noun
skull	ሽክና ርእሲ	ʃɨkɨna rɨʔɨsi	noun
slippery	ሸትሕትሖ	ʃətɨħɨtɨħo	adj
slope	ዓቐብ	ʕaqʰəb	noun
slowness	ዝሕለት	zɨħɨlət	noun
small	ሕንጢል ሕንጥሊቶ	ħɨnɨtʼilɨ ħɨnɨtʼɨlito	noun
small	ንእሽተይ	nɨʔɨʃɨtəj	adj
small/large intestine	ማዓንጣ	maʕanɨtʼa	noun
smart	ጎራሕ	ɡoraħ	adj
smell	ሸተተ	ʃətətə	verb
smile	ፍሽኸታ	fɨʃɨxəta	noun
smile	ፍሽኸታ	fɨʃɨxəta	verb
smiling	ፍሲህ	fɨsih	adj
smith	ኣንጠረኛ	ʔanɨtʼərəɲa	noun
smoke	ኣትከኸ	ʔatɨkəxə	verb
snack	ጠዓሞት	tʼəʕamot	noun
so	ክሳብ ክንድቲ	kɨsabɨ kɨnɨdɨti	adv
so much	ክሳብ ክንድቲ	kɨsabɨ kɨnɨdɨti	adv
sob	ፊቕታ	fiqʰɨta	noun
soccer	ኩእሶ እግሪ	kuʔɨso ʔɨɡɨri	noun
society	ሕብረት ሰብ	ħɨbɨrətɨ səb	noun
sole	ከብዲ ሳእኒ	kəbɨdi saʔɨni	noun
sole of the foot	ከብዲ እግሪ	kəbɨdi ʔɨɡɨri	noun
solemn	ብጹዕ	bɨt͡sʼuʕ	adj
solid	ዝተጨቓጨቑ ኣክራን	zɨtət͡ʃʼəqʰat͡ʃʼəqʰu ʔakɨran	noun
solitary	ጽምው	t͡sʼɨmɨw	adj
solitude	ጽምዋ	t͡sʼɨmɨwa	noun
sometimes	ንሓንሳብ	nɨħanɨsab	adv
soon	ብቑልጡፍ	bɨqʰulɨtʼuf	adv
southern	ደብባዊ	dəbɨbawi	adj
sovereign	ዝለዓለ ገዛኢ	zɨləʕalə ɡəzaʔi	noun
span	መስመራት	məsɨmərat	noun
spark	ማሕታ	maħɨta	noun
sparkle	በለጥ በለ	bələtʼɨ bələ	verb
speak	ተዘረበ	təzərəbə	verb
spectator	ተዓዛቢት	təʕazabit	noun
spend	ኣስረሐ	ʔasɨrəħə	verb
spice	ቀመማት	qəməmat	noun
spiced	ዝግኒ	zɨɡɨni	noun
spiced beans/lentils	ትምቲሞ	tɨmɨtimo	noun
spider	ሳፌት	safet	noun
spinach	ስፐናቺ	sɨpənat͡ʃi	noun
spine	ዓንዲ ሕቔ	ʕanɨdi ħɨqʰe	noun
spit	ጡፍ በለ	tʼufɨ bələ	verb
split	ተፈንጠለ	təfənɨtʼələ	verb
spoil	መሽመሸ	məʃɨməʃə	verb
spoil	ኣባላሸወ	ʔabalaʃəwə	verb
spot	ንጣብ ርስሓት	nɨtʼabɨ rɨsɨħat	noun
spread	ሰጥሐ	sətʼɨħə	verb
spread	ነዝሐ	nəzɨħə	verb
springtime	ኣያት	ʔajat	noun
sprout	በቖለ	bəqʰolə	verb
squander	ሰኹለለ	səxulələ	verb
squeeze	ጸሞቐ	t͡sʼəmoqʰə	verb
squirrel	ምጹጽላይ	mɨt͡sʼut͡sʼɨlaj	noun
stadium	እስታዲዩም	ʔɨsɨtadijum	noun
stage	መድረክ	mədɨrək	noun
stain	ንጣብ ርስሓት	nɨtʼabɨ rɨsɨħat	noun
staircase	መደያይቦ	mədəjajɨbo	noun
stairs	መደያይቦ	mədəjajɨbo	noun
stammer	ባእበአ	baʔɨbəʔə	verb
stamp	ቲምብር	timɨbɨr	noun
stand	ደው	dəw	verb
standing	ጠጠው	tʼətʼəw	adv
stapler	ስተፕረ	sɨtəpɨrə	noun
star	ቀንዲ ተዋሳኢት	qənɨdi təwasaʔit	noun
start	ምጅማር	mɨd͡ʒɨmar	noun
station	መዕረፍ ባብር	məʕɨrəfɨ babɨr	noun
stay	ጽንሒት	t͡sʼɨnɨħit	noun
step	ስጒምቲ	sɨɡʷimɨti	verb
stiff	ጥርዙዝ	tʼɨrɨzuz	adj
sting	ሸቅታ	ʃəqɨta	noun
stitch	እላም	ʔɨlam	noun
stomach	ጨጎራ	t͡ʃʼəɡora	noun
stop	መዕረፍ መጓዓዝያ	məʕɨrəfɨ məɡʷaʕazɨja	noun
story	ዛንታ	zanɨta	noun
story	ጽንጽዋይ	t͡sʼɨnɨt͡sʼɨwaj	noun
straight	ጥርዙዝ	tʼɨrɨzuz	adj
street	ጎደና	ɡodəna	noun
street level	መእተዊ ህንጻ	məʔɨtəwi hɨnɨt͡sʼa	noun
stress	ኣገባብ ኣዘራርባ	ʔaɡəbabɨ ʔazərarɨba	noun
strip	ጥርሑ ኣውጽኦ	tʼɨrɨħu ʔawɨt͡sʼɨʔo	verb
stroll	መዛወሪ	məzawəri	noun
student	ተመሃራይ	təməharaj	noun
subscriber	ምዝጉብ	mɨzɨɡub	noun
suburbs	ጎደቦ	ɡodəbo	noun
sugar	ሽኮር	ʃɨkor	noun
suit	ተሰማምዖ	təsəmamɨʕo	verb
summon to law	ኣጸወዐ	ʔat͡sʼəwəʕə	verb
sunblind	ገራድ ብርሃን	ɡəradɨ bɨrɨhan	noun
superintendent	ሓላው ርሻን	ħalawɨ rɨʃan	noun
supplies	ነገር ንዋት	nəɡərɨ nɨwat	noun
support	መደግፊ	mədəɡɨfi	noun
suppose	መሰሎ	məsəlo	verb
surgeon	ወጔሳ	wəɡʷesa	noun
surprise	ኣገረሀ	ʔaɡərəhə	verb
surrender	ኡዱ ሃበ	ʔudu habə	verb
surround	ኣኸበበ	ʔaxəbəbə	verb
survive	ደሓነ	dəħanə	verb
suspicion	ጥርጥር	tʼɨrɨtʼɨr	noun
sweat	ረሃጸ	rəhat͡sʼə	verb
sweat	ረሃጽ	rəhat͡sʼ	noun
sweat	ርሀጽ	rɨhət͡sʼ	noun
swim	ምሕምባሰ	mɨħɨmɨbasə	noun
swim	ምሕምባሰ	mɨħɨmɨbasə	verb
swing	ሰለል	sələl	noun
switch on	ወለዐ	wələʕə	verb
sword	ጉራዶ	ɡurado	noun
syllable	ኣሃዱ ምድማጽ	ʔahadu mɨdɨmat͡sʼ	noun
sympathy	ዓላነት	ʕalanət	noun
system	ቀጥዒ	qətʼɨʕi	noun
tablecloth	መኽደኒ ጣውላ	məxɨdəni tʼawɨla	noun
take	ተማልአ	təmalɨʔə	verb
take off one's	ጉልባብ ቀልዐ	ɡulɨbabɨ qəlɨʕə	verb
tale	ጽንጽዋይ	t͡sʼɨnɨt͡sʼɨwaj	noun
talk	ብህሊት	bɨhɨlit	noun
taste	ጠዓመ	tʼəʕamə	verb
taste	ጣዐሚ	tʼaʕəmi	noun
tear out	ማሐወ	maħəwə	verb
teardrop	ንብዓት	nɨbɨʕat	noun
tears	ንብዓት	nɨbɨʕat	noun
tease	ማስየ	masɨjə	verb
teff	ጣፍ	tʼaf	noun
telegram	ተለግራም	tələɡɨram	noun
television	ተለቭጅን	tələvɨd͡ʒɨn	noun
temple	ቤተ መቕደስ	betə məqʰɨdəs	noun
temporalis muscle	መታልሕ	mətalɨħ	noun
tenant	ተኻራያይ	təxarajaj	noun
tenderly	ብምልምላም	bɨmɨlɨmɨlam	adv
tent	ድንኳን	dɨnɨkʷan	noun
tenth	ዓስራይ	ʕasɨraj	adj
tenth grade	ዓሽራይ ክፍሊ	ʕaʃɨrajɨ kɨfɨli	noun
terrify	ኣፍረሐ	ʔafɨrəħə	verb
thank you	የቐንየለይ	jəqʰənɨjələj	noun
thaw	ምሕቃቐ	mɨħɨqaqʰə	noun
then	ቀጺሉ	qət͡sʼilu	adv
theory	ክልስ ሓሳብ	kɨlɨsɨ ħasab	noun
thermometer	ተርሞመተር	tərɨmomətər	noun
thick round leavened	ሕንባሻ	ħɨnɨbaʃa	noun
thigh	ሰለፍ	sələf	noun
thin/thick home made cornbread	ሀንዛ	hənɨza	noun
third grade	ሳልሳይ ክፍሊ	salɨsajɨ kɨfɨli	noun
thirteen	ዓሰርተ ሰለስተ	ʕasərɨtə sələsɨtə	noun
thorny	ኣሻኹ	ʔaʃaxu	adj
thresher	ኣኻዲት መኪና	ʔaxaditɨ məkina	noun
through	ቀጥታ ባቡር	qətʼɨta babur	noun
thunder	ነጎዳ	nəɡoda	noun
tight	ጽቢብ	t͡sʼɨbib	adj
tile	መኽደኒ ናሕሲ	məxɨdəni naħɨsi	noun
tired	ስልኩይ	sɨlɨkuj	adj
to	ኣመሰገነ	ʔaməsəɡənə	verb
to try	ጸዓረ	t͡sʼəʕarə	verb
tobacco	ትንባኾ	tɨnɨbaxo	noun
toe	ኣጻዕቲ እግሪ	ʔat͡sʼaʕɨti ʔɨɡɨri	noun
toe nail	ጽፍሪ እግሪ	t͡sʼɨfɨri ʔɨɡɨri	noun
toes	አጻብዕቲ እግሪ	ʔət͡sʼabɨʕɨti ʔɨɡɨri	noun
tolerance	ጽሮት	t͡sʼɨrot	noun
tidiness	ጽሮት	t͡sʼɨrot	noun
cleanliness	ጽሮት	t͡sʼɨrot	noun
tomato	ኮሚደሮ	komidəro	noun
tone	ቅኒት	qɨnit	noun
tonsil	ዓንቐር	ʕanɨqʰər	noun
too	ብዘይመጠን	bɨzəjɨmətʼən	adv
too much	ብዘይመጠን	bɨzəjɨmətʼən	adv
tool	መተዓየዩ	mətəʕajəju	noun
tooth-paste	መሕጸብ ስኒ	məħɨt͡sʼəbɨ sɨni	noun
topic	ብህሊት	bɨhɨlit	noun
toss	ሰጥሐ ንእኽሊ	sətʼɨħə nɨʔɨxɨli	verb
touch	ትንካፈ	tɨnɨkafə	noun
towel	ሽጎማኖ	ʃɨɡomano	noun
town hall	መዘጋጃ ቤተ	məzəɡad͡ʒa betə	noun
town hall	ቤተ ጽሕፈት	betə t͡sʼɨħɨfət	noun
town hall	ክንተባ	kɨnɨtəba	noun
trace	ኣሰር ኣውጸአ	ʔasərɨ ʔawɨt͡sʼəʔə	verb
tractor	ሓራሲት መኪና	ħarasitɨ məkina	noun
trade	ንግዲ	nɨɡɨdi	noun
tragic	ትራጀዳዊ	tɨrad͡ʒədawi	adj
translate	ተርጎመ	tərɨɡomə	verb
transparent	ብርሃን ዘሕልፍ	bɨrɨhanɨ zəħɨlɨf	adj
tray	ጓንተራ	ɡʷanɨtəra	noun
treat	ኣኣንገደ	ʔaʔanɨɡədə	verb
triumph	ፋነነ	fanənə	verb
troop	ዓሳክር	ʕasakɨr	noun
trousers	ስረ	sɨrə	noun
trout	ትራውት ዓሳ	tɨrawɨtɨ ʕasa	noun
truck	መኪና ጽዕነት	məkina t͡sʼɨʕɨnət	noun
tuna	ቶኖ ዓሳ	tono ʕasa	noun
twelfth	ዓሰርተ ክልተ ክፍሊ	ʕasərɨtə kɨlɨtə kɨfɨli	noun
twilight	ጽልግልግ	t͡sʼɨlɨɡɨlɨɡ	noun
uncultivated	ዘይሕረስ	zəjɨħɨrəs	adj
undergarment	ማልያ	malɨja	noun
underground	ትሕቲ ምድሪ	tɨħɨti mɨdɨri	adj
underpants	ሙታንታ	mutanɨta	noun
undress	ጥርሑ ኣውጽኦ	tʼɨrɨħu ʔawɨt͡sʼɨʔo	verb
undress oneself	ጥርሕ ወጽአ	tʼɨrɨħɨ wət͡sʼɨʔə	verb
unhappy	ዘይሕጉስ	zəjɨħɨɡus	adj
unite or combine	ኣስመረ	ʔasɨmərə	verb
united	ሕቡራት	ħɨburat	noun
university	ላዕላይ	laʕɨlaj	noun
university	ዩኒቨርስቲ	junivərɨsɨti	noun
unmarried	ዘይምርዕዉ	zəjɨmɨrɨʕɨwu	noun
unpleasant	ዘየሐጉስ	zəjəħəɡus	adj
unprocessed	ዘይጽሩይ ጽብጻብ	zəjɨt͡sʼɨrujɨ t͡sʼɨbɨt͡sʼab	adj
upright	ጠጠው	tʼətʼəw	adv
upset	ዝጓሃየ	zɨɡʷahajə	adj
use	ኣስረሐ	ʔasɨrəħə	verb
use up	ኣእረገ	ʔaʔɨrəɡə	verb
useful	ተቓሚ	təqʰami	adj
uterus	ማሕጸን	maħɨt͡sʼən	noun
vaccine	ክታቤት	kɨtabet	noun
value	ኣልያሉ ገመተ	ʔalɨjalu ɡəmətə	verb
vanity	ትዕቢት	tɨʕɨbit	noun
varied	ዝተፈለየ	zɨtəfələjə	adj
vein	ሰራዉር	sərawur	noun
vinegar	ኣቸቶ	ʔat͡ʃəto	noun
viper	ኣፍ ዑት	ʔafɨ ʕut	noun
visible	ዝረአ	zɨrəʔə	adj
visit	ምብጻቕ	mɨbɨt͡sʼaqʰ	noun
vocabulary	ማህደረ	mahɨdərə	noun
waiting room	ክፍሊ መጸበዩ	kɨfɨli mət͡sʼəbəju	noun
waking	ሰዓት ደወል	səʕatɨ dəwəl	noun
walk	መዛወሪ	məzawəri	noun
walk	ኣብ ኣገልግሎት ወዓለ	ʔabɨ ʔaɡəlɨɡɨlotɨ wəʕalə	verb
wallet	እንዳ ገንዘብ	ʔɨnɨda ɡənɨzəb	noun
war	ኩናት	kunat	noun
warm	ኣውዓየ	ʔawɨʕajə	verb
warning	መጠንቐቕታ	mətʼənɨqʰəqʰɨta	noun
wash one’s self	ተሓጸበ	təħat͡sʼəbə	verb
waste	ዘይሕረስ	zəjɨħɨrəs	adj
watch	ሰዓት ኢድ	səʕatɨ ʔid	noun
water melon	ብርጭቕ	bɨrɨt͡ʃʼɨqʰ	noun
water spray	ንጽጎ ማይ	nɨt͡sʼɨɡo maj	noun
watering can	መረብረቢ	mərəbɨrəbi	noun
way	ቀጥዒ	qətʼɨʕi	noun
way down	ቁልቁለት	qulɨqulət	noun
weary	ስልኩይ	sɨlɨkuj	adj
welcome	ኣቀባብላ	ʔaqəbabɨla	noun
welcome	ደሓን መጸ	dəħanɨ mət͡sʼə	adj
wheel	መንኮርኮር	mənɨkorɨkor	noun
when	መኣስ	məʔas	adv
whip	ኩርማጅጅ	kurɨmad͡ʒɨd͡ʒ	noun
whisper	ሕሹኽሹኽ በለ	ħɨʃuxɨʃuxɨ bələ	verb
whisper	ኣሕሸኹሸኸ	ʔaħɨʃəxuʃəxə	verb
whistle	ጩቕጩቕ በለ	t͡ʃʼuqʰɨt͡ʃʼuqʰɨ bələ	verb
whistle	ፊጽፊጽ	fit͡sʼɨfit͡sʼ	noun
whistle	ብምጭዳር ተቓወመ	bɨmɨt͡ʃʼɨdarɨ təqʰawəmə	verb
widen	ኣግፈሐ	ʔaɡɨfəħə	verb
widowed	ሰብኣያ ዝሞታ	səbɨʔaja zɨmota	noun
width	ግፍሓት	ɡɨfɨħat	noun
willingly	ብታሕጓስ	bɨtaħɨɡʷas	adv
willow	ዊሎው	wilow	noun
window	ተደራቢ መስኮት	tədərabi məsɨkot	noun
windpipe	ቃራየ ጉርጉማ	qarajə ɡurɨɡuma	noun
wine-harvest	እርያ ወይኒ	ʔɨrɨja wəjɨni	noun
wintry	ናይ ክረምቲ	najɨ kɨrəmɨti	adj
wipe	ኣንቀጸ	ʔanɨqət͡sʼə	verb
wish for	ተተምነየ	tətəmɨnəjə	verb
wolf	ተኹላ	təxula	noun
wonder	ተደነቐ	tədənəqʰə	verb
woodcutter	ቆራጽ ዕንጸይቲ	qorat͡sʼɨ ʕɨnɨt͡sʼəjɨti	noun
workshop	ክፍሊ ስራሕ	kɨfɨli sɨraħ	noun
workshop	ቤተ ዕዮ	betə ʕɨjo	noun
worn	ልባስ	lɨbas	adj
worn	ካልኣይ ኢድ	kalɨʔajɨ ʔid	adj
worried	ዝተሻቐለ	zɨtəʃaqʰələ	adj
worry about	ተሻቐለ	təʃaqʰələ	verb
wound	መቑሰልቲ	məqʰusəlɨti	noun
wretched	ከርፋሕ	kərɨfaħ	adj
wrinkle	ዕጣሮ	ʕɨtʼaro	noun
write	ጽሓፈ	t͡sʼɨħafə	verb
yellow	ቢጫ	bit͡ʃʼa	adj
yogurt	ሩግኦ	ruɡɨʔo	noun
zoology	ስነ እንስሳ	sɨnə ʔɨnɨsɨsa	noun
zucchini	ዙኪኒ	zukini	noun
