hemp	hmp	ሀምፕ
cornbread	hnz	ሀንዛ
crescent	hll	ሂላል
life	hwt	ሂወት
prodigal	hjb	ሂያብ
offering	hjb	ሂያብ
stand	hlw	ሃለ'ወ
bray	hll	ሃለለ
hammock	hll	ሃለለ
peak	hlx	ሃለኸ
bear	hlw	ሃለዎ
booby	hlj	ሃላይ
stick	hlj	ሃላይ
consumption	hlk	ሃልኪ
sink	hmm	ሃመመ
fly	hmm	ሃመማ
crater	hmm	ሃማም
dogma	hmn	ሃሜን
strike	hrm	ሃረመ
pelt	hrm	ሃረመ
throb	hrm	ሃረመ
hit	hrm	ሃረመ
beat	hrm	ሃረመ
pyramid	hrm	ሃረም
pine	hrf	ሃረፈ
knocker	hrm	ሃራሚ
hurt	hsj	ሃሰየ
torture	hsj	ሃሰየ
hit	hsj	ሃሰየ
matt	hss	ሃሳስ
attempt	hqn	ሃቀነ
essay	hqn	ሃቀነ
fortune	hbt	ሃብቲ
resource	hbt	ሃብቲ
opulence	hbt	ሃብቲ
affluence	hbt	ሃብቲ
property	hbt	ሃብቲ
wealth	hbt	ሃብቲ
build	hnt͡sʼ	ሃነጸ
construct	hnt͡sʼ	ሃነጸ
sense	hws	ሃወሰ
monkey	hwx	ሃወኸ
rush	hwx	ሃወኸ
temerity	hwx	ሃወኽ
tear	hwt͡sʼ	ሃወጸ
sensor	hws	ሃዋሲ
convulsion	hwk	ሃውኪ
levant	hdm	ሃደመ
run	hdm	ሃደመ
bunk	hdm	ሃደመ
hunt	hdn	ሃደነ
chevy	hdn	ሃደነ
runaway	hdm	ሃዲም
pursuit	hdn	ሃድን
calm	hdʔ	ሃድአ
assault	hd͡ʒm	ሃጀመ
storm	hd͡ʒm	ሃጀመ
charge	hd͡ʒm	ሃጀመ
debt	hɡr	ሃገር
country	hɡr	ሃገር
land	hɡr	ሃገር
nation	hɡr	ሃገር
crevasse	hɡʷm	ሃጓም
pitfall	hɡʷm	ሃጓም
rift	hɡʷf	ሃጓፍ
dint	hɡʷf	ሃጓፍ
depression	hɡʷf	ሃጓፍ
groove	hɡʷf	ሃጓፍ
crevasse	hɡʷf	ሃጓፍ
dent	hɡʷf	ሃጓፍ
crater	hɡʷf	ሃጓፍ
emperor	ht͡sʼj	ሃጸይ
gust	ht͡sʼf	ሃጽፊ
steam	hff	ሃፈፈ
heron	hrn	ሄሮን
eve	hwn	ሄዋን
entity	hlw	ህላወ
attendance	hlw	ህላወ
presence	hlw	ህላወ
existence	hlw	ህላወ
being	hlw	ህላወ
existence	hlw	ህላዌ
presence	hlw	ህላዌ
shake	hmt	ህሞት
moment	hmt	ህሞት
miser	hrf	ህሩፍ
glutton	hrf	ህሩፍ
harm	hsj	ህሳ'ይ
monkey	hbj	ህበይ
baboon	hbj	ህበይ
cult	hbb	ህቡብ
hero	hbb	ህቡብ
slush	hnn	ህና'ነ
barn	hnt͡sʼ	ህንጻ
structure	hnt͡sʼ	ህንጻ
architecture	hnt͡sʼ	ህንጻ
building	hnt͡sʼ	ህንጻ
construction	hnt͡sʼ	ህንጻ
sense	hws	ህዋስ
people	hzb	ህዝቢ
folk	hzb	ህዝቢ
public	hzb	ህዝቢ
population	hzb	ህዝቢ
country	hzb	ህዝቢ
forum	hzb	ህዝቢ
criticism	hjs	ህየሳ
gift	hjb	ህያብ
donation	hjb	ህያብ
presentation	hjb	ህያብ
settlement	hjb	ህያብ
offering	hjb	ህያብ
present	hjb	ህያብ
purse	hjb	ህያብ
premium	hjb	ህያብ
offer	hjb	ህያብ
calm	hdʔ	ህዱእ
halcyon	hdʔ	ህዱእ
cool	hdʔ	ህዱእ
escape	hdm	ህድማ
velvet	hdʔ	ህድእ
assault	hd͡ʒm	ህጁም
charge	hd͡ʒm	ህጁም
perfume	htʼr	ህጥር
short	ht͡sʼt͡sʼ	ህጹጽ
baby	ht͡sʼn	ህጻን
infant	ht͡sʼn	ህጻን
babe	ht͡sʼn	ህጻን
evaporation	hft	ህፈት
motel	htl	ሆቴል
inn	htl	ሆቴል
hotel	htl	ሆቴል
filter	lħm	ለሓመ
lick	lħs	ለሓሰ
leak	lħxʷ	ለሓዅ
urge	lmn	ለመነ
appeal	lmn	ለመነ
smear	lmt͡sʼ	ለመጸ
rind	lmn	ለሚን
lime	lmn	ለሚን
lemon	lmn	ለሚን
reptile	lmm	ለማሚ
lank	lmʃ	ለማሽ
bum	lmn	ለማኒ
greenery	lmʕ	ለምዒ
annex	lqb	ለቀ'በ
pod	lqt	ለቆተ
node	lqʰm	ለቐመ
release	lqʰqʰ	ለቐቐ
acquit	lqʰqʰ	ለቐቐ
loan	lqʰħ	ለቓሕ
pod	lqʰt	ለቖታ
sac	lqʰʷt	ለቘታ
apparel	lbs	ለበሰ
array	lbs	ለበሰ
wear	lbs	ለበሰ
recommendation	lbw	ለበዋ
will	lbw	ለበዋ
testament	lbw	ለበዋ
cognizant	lbw	ለበዋ
eruption	lbd	ለበዳ
cake	lbtʼ	ለበጠ
sage	lbm	ለባም
wise	lbm	ለባም
politic	lbm	ለባም
epidemic	lbʕ	ለብዒ
dispatch	lʔx	ለኣኸ
export	lʔx	ለኣኸ
spread	lxj	ለኸየ
flex	lwj	ለወየ
fold	lwj	ለወየ
curve	lwj	ለወየ
bend	lwj	ለወየ
shift	lwtʼ	ለወጠ
change	lwtʼ	ለወጠ
convert	lwtʼ	ለወጠ
turn	lwtʼ	ለወጠ
human	lwh	ለዋህ
kind	lwh	ለዋህ
change	lwtʼ	ለውጢ
variation	lwtʼ	ለውጢ
evolution	lwtʼ	ለውጢ
conversion	lwtʼ	ለውጢ
barter	lwtʼ	ለውጢ
mutation	lwtʼ	ለውጢ
swap	lwtʼ	ለውጢ
variety	lwtʼ	ለውጢ
transformation	lwtʼ	ለውጢ
advance	lʕl	ለዓለ
shank	lʕt	ለዓት
handle	lʕt	ለዓት
knob	lʕt	ለዓት
lyre	ljr	ለየር
night	ljt	ለይቲ
show	lɡs	ለገሰ
donor	lɡs	ለጋሲ
giver	lɡs	ለጋስ
liberal	lɡs	ለጋስ
sticker	lɡb	ለጋቢ
load	lɡʷm	ለጐመ
button	lɡʷm	ለጐመ
placard	ltʼf	ለጠፈ
cake	ltʼf	ለጠፈ
smear	ltʼf	ለጠፈ
poster	ltʼf	ለጣፊ
annex	lt͡sʼqʰ	ለጸቐ
slave	lfʕ	ለፍዐ
woody	lħw	ሉሓዊ
slush	lnɡ	ሉንጊ
lymph	lmf	ሊምፍ
litre	ltr	ሊተር
lingo	lnɡ	ሊንጎ
lacquer	lkr	ሊከር
liqueur	lkr	ሊከር
litany	ltʼn	ሊጦን
spleen	llʃ	ላልሽ
leak	lħkʷ	ላሕኲ
leakage	lħkʷ	ላሕኲ
kerosene	lmb	ላምባ
larva	lrv	ላርቫ
grub	lrv	ላርቫ
appendix	lqʰb	ላቔባ
adjunct	lqʰb	ላቔባ
appendage	lqʰb	ላቔባ
latin	ltn	ላቲን
larynx	lnq	ላንቃ
high	lʕl	ላዕሊ
top	lʕl	ላዕሊ
lagoon	lɡn	ላጉን
adhesive	lɡb	ላጋቢ
prank	lɡt͡sʼ	ላግጺ
trick	lɡt͡sʼ	ላግጺ
razor	lt͡sʼj	ላጸየ
shave	lt͡sʼj	ላጸየ
publicity	llj	ልልይ
tow	lħt͡sʼ	ልሕጺ
routine	lmd	ልሙድ
current	lmd	ልሙድ
flat	lmt͡sʼ	ልሙጽ
slick	lmt͡sʼ	ልሙጽ
routine	lmd	ልማድ
experience	lmd	ልምዲ
tradition	lmd	ልምዲ
practice	lmd	ልምዲ
groove	lmd	ልምዲ
usage	lmd	ልምዲ
custom	lmd	ልምዲ
norm	lmd	ልምዲ
tongue	lsn	ልሳን
organ	lsn	ልሳን
loan	lqʰħ	ልቓሕ
credit	lqʰħ	ልቓሕ
infection	lbd	ልበዳ
apparel	lbs	ልብሲ
suit	lbs	ልብሲ
wisdom	lbn	ልቦና
ability	lbn	ልቦና
prince	lʔl	ልኡል
ambassador	lʔx	ልኡኽ
agent	lʔx	ልኡኽ
messenger	lʔx	ልኡኽ
emissary	lʔx	ልኡኽ
mission	lʔx	ልኡኽ
dosage	lkʕ	ልክዕ
maniac	lxf	ልኹፍ
cream	lxj	ልኻይ
ointment	lxj	ልኻይ
variant	lwtʼ	ልውጥ
noble	lʕl	ልዑል
patrician	lʕl	ልዑል
peer	lʕl	ልዑል
count	lʕl	ልዑል
paramount	lʕl	ልዑል
extreme	lʕl	ልዑል
over	lʕl	ልዕሊ
aristocrat	lʕl	ልዕል
saliva	lzj	ልዛይ
negotiation	lzb	ልዝብ
christmas	ldt	ልደት
sill	ldt	ልዳት
threshold	ldt	ልዳት
graft	lɡb	ልገ'ባ
patch	lɡb	ልጋ'ብ
percussion	lɡʕ	ልግ'ዕ
charity	lɡs	ልግሲ
altruism	lɡs	ልግሲ
variance	lɡs	ልግሶ
bit	lɡʷm	ልጓም
ribbon	lɡʷm	ልጓም
brake	lɡʷm	ልጓም
patch	ltʼf	ልጣፍ
shave	lt͡sʼj	ልጻይ
mucous	lft͡ʃʼ	ልፋጭ
mucus	lft͡ʃʼ	ልፋጭ
declaration	lff	ል’ፈፋ
locket	lkt	ሎከት
padlock	lkt	ሎኬቶ
advocate	ħɡz	ሐገዝ
cough	ħʔt	ሑአታ
brick	ħtʼb	ሑጡብ
pith	ħll	ሒለል
earthenware	ħlb	ሒላብ
crumb	ħdt	ሒደት
inch	ħdt	ሒደት
low	ħdt	ሒደት
pittance	ħdt	ሒደት
dream	ħlm	ሓለመ
president	ħlqʰ	ሓለቓ
warden	ħlqʰ	ሓለቓ
chief	ħlqʰ	ሓለቓ
general	ħlqʰ	ሓለቓ
director	ħlqʰ	ሓለቓ
principal	ħlqʰ	ሓለቓ
superior	ħlqʰ	ሓለቓ
monitor	ħlqʰ	ሓለቓ
head	ħlqʰ	ሓለቓ
provost	ħlqʰ	ሓለቓ
commander	ħlqʰ	ሓለቓ
belt	ħlb	ሓለበ
milk	ħlb	ሓለበ
aim	ħln	ሓለነ
mean	ħln	ሓለነ
keep	ħlw	ሓለወ
preserve	ħlw	ሓለወ
ward	ħlw	ሓለዋ
guard	ħlw	ሓለዋ
watch	ħlw	ሓለዋ
vigil	ħlw	ሓለዋ
pass	ħlf	ሓለፈ
outreach	ħlf	ሓለፈ
dreamer	ħlm	ሓላሚ
aspirant	ħln	ሓላኒ
defender	ħlw	ሓላዊ
boss	ħlf	ሓላፊ
sponsor	ħlf	ሓላፊ
president	ħlf	ሓላፊ
warden	ħlf	ሓላፊ
chief	ħlf	ሓላፊ
manager	ħlf	ሓላፊ
director	ħlf	ሓላፊ
head	ħlf	ሓላፊ
monitor	ħlf	ሓላፊ
commander	ħlf	ሓላፊ
privilege	ħlf	ሓላፋ
trans	ħlf	ሓላፍ
sieve	ħħj	ሓሓየ
ship	ħmr	ሓመር
gossip	ħmj	ሓመየ
soil	ħmd	ሓመድ
dirt	ħmd	ሓመድ
thursday	ħms	ሓሙስ
july	ħml	ሓምለ
vegetable	ħml	ሓምሊ
gall	ħmt	ሓሞት
bile	ħmt	ሓሞት
grill	ħrr	ሓረረ
char	ħrr	ሓረረ
plow	ħrs	ሓረሰ
farm	ħrs	ሓረሰ
flare	ħrqʰ	ሓረቐ
initiative	ħrn	ሓረን
knife	ħrd	ሓረደ
trailer	ħrɡ	ሓረግ
phrase	ħrɡ	ሓረግ
pedigree	ħrɡ	ሓረግ
trellis	ħrɡ	ሓረግ
usury	ħrtʼ	ሓረጣ
harem	ħrm	ሓሪም
rhinoceros	ħrʃ	ሓሪሽ
flour	ħrt͡ʃʼ	ሓሪጭ
tiller	ħrs	ሓራሲ
auctioneer	ħrd͡ʒ	ሓራጂ
auction	ħrd͡ʒ	ሓራጅ
uncle	ħrd͡ʒ	ሓራጅ
puddle	ħrt	ሓሬት
shit	ħrʔ	ሓርአ
crap	ħrʔ	ሓርኢ
shit	ħrʔ	ሓርኢ
flour	ħrt͡ʃʼ	ሓርጭ
tablespoon	ħrt͡ʃʼ	ሓርጭ
powder	ħrt͡ʃʼ	ሓርጭ
pig	ħsm	ሓሰማ
hog	ħsm	ሓሰማ
thatch	ħsr	ሓሰር
fodder	ħsr	ሓሰር
hay	ħsr	ሓሰር
mean	ħsb	ሓሰበ
bug	ħsx	ሓሰኻ
lie	ħsw	ሓሰወ
demise	ħsb	ሓሳብ
idea	ħsb	ሓሳብ
image	ħsb	ሓሳብ
thought	ħsb	ሓሳብ
suggestion	ħsb	ሓሳብ
paradox	ħsb	ሓሳብ
notion	ħsb	ሓሳብ
worm	ħsx	ሓሳኻ
informer	ħsw	ሓሳዊ
hollow	ħst	ሓሶት
bug	ħʃr	ሓሸራ
informer	ħʃl	ሓሹል
dope	ħʃʃ	ሓሽሽ
thaw	ħqʰqʰ	ሓቐቐ
crystal	ħqʰqʰ	ሓቒቕ
hug	ħqʰf	ሓቖፈ
hug	ħqʰʷf	ሓቘፈ
folder	ħqʰʷf	ሓቛፊ
import	ħbr	ሓበ'ረ
jail	ħbs	ሓበሰ
pride	ħbn	ሓበን
bulge	ħbtʼ	ሓበጠ
dial	ħbr	ሓባ'ሪ
harbinger	ħbr	ሓባሪ
indicator	ħbr	ሓባሪ
pointer	ħbr	ሓባሪ
index	ħbr	ሓባሪ
informant	ħbr	ሓባሪ
sister	ħbt	ሓብቲ
cache	ħbʔ	ሓብአ
residuum	ħtl	ሓተላ
cap	ħtm	ሓተመ
stop	ħtm	ሓተመ
imprint	ħtm	ሓተመ
stamp	ħtm	ሓተመ
interview	ħtt	ሓተተ
claim	ħtt	ሓተተ
demand	ħtt	ሓተተ
quiz	ħtt	ሓተተ
comment	ħtt	ሓተታ
commentary	ħtt	ሓተታ
publisher	ħtm	ሓታሚ
questioner	ħtt	ሓታቲ
applicant	ħtt	ሓታቲ
commentator	ħtt	ሓታቲ
aunt (mother's side)	ħtn	ሓትነ
aunt (mother's side)	ħtn	ሓትኖ
collar	ħnqʰ	ሓነቐ
throttle	ħnqʰ	ሓነቐ
scalp	ħnt	ሓናት
doctor	ħkm	ሓከመ
cure	ħkm	ሓከመ
doctor	ħkm	ሓኪም
physician	ħkm	ሓኪም
laziness	ħxt	ሓኸተ
scratch	ħxx	ሓኸኸ
shaft	ħxl	ሓኽሊ
handle	ħxl	ሓኽሊ
climb	ħxʷr	ሓዀረ
creeper	ħxʷr	ሓዃሪ
combine	ħws	ሓወሰ
mix	ħws	ሓወሰ
uncle	ħwb	ሓወቦ
draft	ħwl	ሓዋላ
foal	ħwl	ሓውለ
sub	ħws	ሓውሲ
sister	ħwt	ሓውቲ
reservoir	ħwt͡sʼ	ሓውጺ
tank	ħwt͡sʼ	ሓውጺ
heartache	ħzn	ሓዘን
depression	ħzn	ሓዘን
cloud	ħzn	ሓዘን
lion	ħjt	ሓየት
steam	ħjl	ሓይሊ
dint	ħjl	ሓይሊ
power	ħjl	ሓይሊ
potency	ħjl	ሓይሊ
violence	ħjl	ሓይሊ
muscle	ħjl	ሓይሊ
coercion	ħjl	ሓይሊ
strength	ħjl	ሓይሊ
tutelage	ħdr	ሓደራ
leave	ħdɡ	ሓደገ
thunderbolt	ħdɡ	ሓደጋ
hazard	ħdɡ	ሓደጋ
accident	ħdɡ	ሓደጋ
risk	ħdɡ	ሓደጋ
danger	ħdɡ	ሓደጋ
fatality	ħdɡ	ሓደጋ
casualty	ħdɡ	ሓደጋ
strange	ħdʃ	ሓዲሽ
rail	ħdd	ሓዲድ
railway	ħdd	ሓዲድ
railroad	ħdd	ሓዲድ
quandary	ħdɡ	ሓዲግ
household	ħdr	ሓዳር
marriage	ħdr	ሓዳር
sweet	ħdʃ	ሓድሽ
novice	ħdʃ	ሓድሽ
new	ħdʃ	ሓድሽ
legacy	ħdɡ	ሓድጊ
scion	ħdɡ	ሓድጊ
abscess	ħɡl	ሓገል
aid	ħɡz	ሓገዘ
assist	ħɡz	ሓገዘ
service	ħɡz	ሓገዝ
assistance	ħɡz	ሓገዝ
recipient	ħɡz	ሓገዝ
helper	ħɡz	ሓጋዚ
assistant	ħɡz	ሓጋዚ
friend	ħɡz	ሓጋዚ
subsidiary	ħɡz	ሓጋዚ
accessory	ħɡz	ሓጋዚ
collateral	ħɡz	ሓጋዚ
benefit	ħɡz	ሓጋዚ
winter	ħɡj	ሓጋይ
legislator	ħɡɡ	ሓጋጊ
triumph	ħɡs	ሓጎስ
happiness	ħɡʷs	ሓጐስ
satisfaction	ħɡʷs	ሓጐስ
joy	ħɡʷs	ሓጐስ
exhilaration	ħɡʷs	ሓጐስ
forge	ħɡʷd	ሓጐደ
sin	ħtʼʔ	ሓጥእ
tease	ħt͡ʃʼt͡ʃʼ	ሓጨጨ
kid	ħt͡ʃʼt͡ʃʼ	ሓጨጨ
fence	ħt͡sʼr	ሓጸረ
decrease	ħt͡sʼr	ሓጸረ
flush	ħt͡sʼb	ሓጸበ
wash	ħt͡sʼb	ሓጸበ
bath	ħt͡sʼb	ሓጸበ
bracket	ħt͡sʼr	ሓጹር
cordon	ħt͡sʼr	ሓጹር
brief	ħt͡sʼr	ሓጺር
short	ħt͡sʼr	ሓጺር
little	ħt͡sʼr	ሓጺር
iron	ħt͡sʼn	ሓጺን
template	ħt͡sʼn	ሓጺን
reservoir	ħt͡sʼb	ሓጽቢ
sister	ħft	ሓፍቲ
extreme	ħlf	ሕሉ'ፍ
valley	ħlm	ሕሉም
dell	ħlm	ሕሉም
glen	ħlm	ሕሉም
dale	ħlm	ሕሉም
preservation	ħlw	ሕሉው
past	ħlf	ሕሉፍ
vision	ħlm	ሕልሚ
fantasy	ħlm	ሕልሚ
dream	ħlm	ሕልሚ
conscience	ħln	ሕልና
excess	ħlf	ሕልፊ
incapacity	ħmqʰ	ሕመቕ
disability	ħmqʰ	ሕመቕ
coke	ħmt	ሕመት
ill	ħmm	ሕሙም
sick	ħmm	ሕሙም
epidemic	ħmm	ሕማም
illness	ħmm	ሕማም
disease	ħmm	ሕማም
complaint	ħmm	ሕማም
ailment	ħmm	ሕማም
gross	ħmqʰ	ሕማቕ
gossip	ħmt	ሕሜታ
havoc	ħmt	ሕሜት
deprivation	ħrm	ሕራመ
scorch	ħrr	ሕራር
sale	ħrd͡ʒ	ሕራጀ
taboo	ħrm	ሕርሚ
agriculture	ħrʃ	ሕርሻ
husbandry	ħrʃ	ሕርሻ
farm	ħrʃ	ሕርሻ
preference	ħrj	ሕርያ
selection	ħrj	ሕርያ
ramrod	ħsm	ሕሰም
evil	ħsm	ሕሱም
math	ħsb	ሕሳብ
mathematics	ħsb	ሕሳብ
sum	ħsb	ሕሳብ
bill	ħsb	ሕሳብ
account	ħsb	ሕሳብ
solution	ħqqʰ	ሕቃቕ
hug	ħqʰʷf	ሕቝፊ
lap	ħqʰʷf	ሕቝፊ
knob	ħbtʼ	ሕበጥ
bulge	ħbtʼ	ሕበጥ
bump	ħbtʼ	ሕበጥ
prisoner	ħbs	ሕቡስ
occult	ħbʔ	ሕቡእ
cache	ħbʔ	ሕቡእ
tone	ħbr	ሕብሪ
colour	ħbr	ሕብሪ
hydrogen	ħbr	ሕብሪ
hub	ħbj	ሕብያ
imprint	ħtm	ሕታም
publication	ħtm	ሕታም
literature	ħtm	ሕታም
edition	ħtm	ሕታም
impression	ħtm	ሕታም
copy	ħtm	ሕታም
venom	ħnz	ሕንዚ
poison	ħnz	ሕንዚ
cake	ħnz	ሕንዚ
discernment	ħnd	ሕንዳ
gay	ħws	ሕዉስ
mixture	ħws	ሕዋስ
gay	ħws	ሕውስ
mixer	ħws	ሕውስ
innovation	ħds	ሕደሳ
renewal	ħds	ሕደሳ
november	ħdr	ሕዳር
renaissance	ħds	ሕዳሰ
gay	ħɡs	ሕጉስ
content	ħɡs	ሕጉስ
right	ħɡw	ሕጋዊ
legislation	ħɡɡ	ሕጋገ
rule	ħɡɡ	ሕጋግ
pen	ħt͡sʼr	ሕጹር
candidate	ħt͡sʼj	ሕጹይ
nominee	ħt͡sʼj	ሕጹይ
contraction	ħt͡sʼr	ሕጻር
baby	ħt͡sʼn	ሕጻን
infant	ħt͡sʼn	ሕጻን
child	ħt͡sʼn	ሕጻን
train	mhr	መሃረ
mentor	mhr	መሃሪ
manufacture	mhz	መሃዘ
original	mhz	መሃዚ
author	mhz	መሃዚ
composer	mhz	መሃዚ
pay	mhj	መሃያ
salary	mhj	መሃያ
wage	mhj	መሃያ
recall	mls	መለሰ
answer	mls	መለሰ
variety	mls	መለሳ
alternative	mls	መለሳ
reply	mlʃ	መለሸ
sneak	mlqʰʷ	መለቘ
slide	mlqʰʷ	መለቘ
slip	mlqʰʷ	መለቝ
supplement	mlʔ	መለአ
insignia	mlj	መለዮ
badge	mlj	መለዮ
constituent	mlʔ	መላ'ኢ
dictator	mlx	መላኺ
razor	mlt͡sʼ	መላጸ
trigger	mlt͡sʼ	መላጸ
response	mls	መልሲ
reply	mls	መልሲ
answer	mls	መልሲ
replication	mls	መልሲ
glut	mlʔ	መልአ
bag	mlʔ	መልአ
fill	mlʔ	መልአ
bottle	mlʔ	መልአ
surfeit	mlʔ	መልአ
aria	mld	መሎዲ
excuse	mħr	መሓረ
draw	mħw	መሓወ
society	mħz	መሓዙ
companion	mħz	መሓዛ
buddy	mħz	መሓዛ
pal	mħz	መሓዛ
friend	mħz	መሓዛ
baby	mmj	መማዪ
censor	mmj	መማይ
mummy	mmj	መምያ
mum	mmj	መምያ
heater	mmqʰ	መሞቒ
soup	mrqʰ	መረቕ
broth	mrqʰ	መረቕ
gravy	mrqʰ	መረቕ
patio	mrb	መረባ
rust	mrt	መረተ
elect	mrt͡sʼ	መረጸ
pick	mrt͡sʼ	መረጸ
ballot	mrt͡sʼ	መረጸ
vote	mrt͡sʼ	መረጸ
return	mrt͡sʼ	መረጸ
vanguard	mrħ	መሪሕ
director	mrħ	መራሒ
leader	mrħ	መራሒ
electorate	mrt͡sʼ	መራጾ
ballot	mrt͡sʼ	መራጾ
vote	mrt͡sʼ	መራጾ
election	mrt͡sʼ	መራጾ
field	mrt	መሬት
globe	mrt	መሬት
earth	mrt	መሬት
tenure	mrt	መሬት
floor	mrt	መሬት
territory	mrt	መሬት
land	mrt	መሬት
soil	mrt	መሬት
head	mrħ	መርሐ
fly	mrħ	መርሐ
lead	mrħ	መርሐ
usher	mrħ	መርሐ
pilot	mrħ	መርሐ
conduct	mrħ	መርሓ
haven	mrs	መርሳ
march	mrʃ	መርሻ
match	mrʕ	መርዓ
wedding	mrʕ	መርዓ
wedlock	mrʕ	መርዓ
marriage	mrʕ	መርዓ
venom	mrz	መርዚ
poison	mrz	መርዚ
think	msl	መሰለ
title	msl	መሰል
prerogative	msl	መሰል
contemporary	mst	መሰታ
screw	msn	መሰኒ
craze	mstʼ	መሰጠ
thriller	mstʼ	መሳጢ
tableau	mstʼ	መሳጢ
butler	mst	መስተ
beverage	mst	መስተ
drink	mst	መስተ
irrigation	msn	መስኖ
pitchfork	msʔ	መስአ
guess	mʃl	መሸላ
draw	mʃt	መሸተ
stockade	mʃɡ	መሸገ
sale	mʃtʼ	መሸጣ
hairdresser	mʃtʼ	መሻጢ
setting	mqn	መቃን
mount	mqn	መቃን
frame	mqn	መቃን
segment	mqʰl	መቐለ
divide	mqʰl	መቐለ
scissors	mqʰs	መቐስ
scissors	mqʰz	መቐዝ
chain	mqʰħ	መቑሕ
partition	mqʰl	መቓሊ
pedestal	mqʰm	መቖሚ
component	mqʰʷm	መቘሚ
furniture	mbl	መበሊ
hoe	mbr	መባሮ
relay	mbr	መብረ
alternative	mbr	መብረ
privilege	mbt	መብቲ
penis	mtl	መትሎ
nerve	mtn	መትኒ
leader	mtn	መትኒ
motor	mtn	መትኒ
lighthouse	mnr	መናራ
mineral	mnr	መናራ
celibacy	mnn	መናኒ
crevice	mnq	መንቂ
fissure	mnq	መንቂ
crowbar	mnq	መንቂ
interim	mnɡ	መንጎ
bromide	mɲk	መኛካ
nutrition	mʔz	መኣዛ
fragrance	mʔz	መኣዛ
tonic	mʔz	መኣዛ
aroma	mʔz	መኣዛ
mess	mʔd	መኣዲ
dish	mʔd	መኣዲ
fare	mʔd	መኣዲ
meal	mʔd	መኣዲ
hall	mʔt	መእቶ
mire	mkr	መከራ
evil	mkr	መከራ
coupe	mkn	መኪና
auto	mkn	መኪና
van	mkn	መኪና
car	mkn	መኪና
engine	mkn	መኪና
machine	mkn	መኪና
oracle	mkr	መካር
namesake	mkʷs	መኵሲ
herb	mxl	መኸል
hay	mxl	መኸል
defence	mxt	መኸተ
fuse	mxx	መኸኸ
thaw	mxx	መኸኸ
venture	mxr	መኻሪ
locus	mxn	መኻን
site	mxn	መኻን
finance	mwl	መወለ
victor	mwʔ	መዋኢ
preserve	mʕr	መዓረ
honey	mʕr	መዓር
inferno	mʕt	መዓት
jungle	mʕt	መዓት
visitation	mʕt	መዓት
bushel	mʕt	መዓት
buffet	mʕt	መዓት
disaster	mʕt	መዓት
aroma	mʕz	መዓዛ
mentor	mʕd	መዓዲ
appointment	mzz	መዘ'ዘ
balance	mzn	መዘነ
counterpart	mzn	መዘና
peer	mzn	መዘና
institute	mzz	መዘዘ
consequence	mzz	መዘዝ
upshot	mzz	መዘዝ
address	mdr	መደ'ረ
address	mdr	መደረ
schedule	mdb	መደብ
idea	mdb	መደብ
budget	mdb	መደብ
terrace	mdb	መደብ
programme	mdb	መደብ
assignment	mdb	መደብ
hour	mdb	መደብ
speaker	mdr	መዳሪ
aspect	mdj	መዳይ
gong	mdl	መድሎ
chime	mdl	መድሎ
stage	mɡʃ	መገሺ
journey	mɡʃ	መገሻ
feed	mɡb	መገበ
saw	mɡz	መገዘ
junction	mɡd	መገዲ
avenue	mɡd	መገዲ
wayside	mɡd	መገዲ
journey	mɡd	መገዲ
route	mɡd	መገዲ
probability	mɡd	መገዲ
guardian	mɡz	መጉዚ
trustee	mɡz	መጋ'ዚ
food	mɡb	መጋቢ
cache	mɡb	መጋቢ
tonic	mɡb	መጋቢ
saw	mɡz	መጋዝ
pus	mɡl	መግሊ
meal	mɡb	መግቢ
tuck	mɡb	መግቢ
food	mɡb	መግቢ
diet	mɡb	መግቢ
praise	mɡs	መጎስ
argument	mɡt	መጎተ
dialectic	mɡt	መጎት
argument	mɡʷt	መጐተ
pus	mɡʷl	መጓሊ
flock	mɡʷs	መጓሰ
herd	mɡʷs	መጓሰ
map	mtʼn	መጠነ
dose	mtʼn	መጠን
quantum	mtʼn	መጠን
maximum	mtʼn	መጠን
dosage	mtʼn	መጠን
proportion	mtʼn	መጠን
rate	mtʼn	መጠን
magnitude	mtʼn	መጠን
percentage	mtʼn	መጠን
dole	mtʼw	መጠወ
stretch	mtʼtʼ	መጠጠ
giver	mtʼw	መጣዊ
stigma	mtʼɡ	መጣጊ
milk	mt͡sʼj	መጸየ
drink	mt͡sʼj	መጸየ
acid	mt͡sʼt͡sʼ	መጺጽ
tart	mt͡sʼt͡sʼ	መጺጽ
future	mt͡sʼʔ	መጻኢ
parasite	mt͡sʼj	መጻዪ
sucker	mt͡sʼj	መጻዪ
pest	mt͡sʼj	መጻዪ
culture	mfr	መፍረ
team	mfr	መፍረ
temperature	mqʰt	ሙቐት
music	mzq	ሙዚቃ
mink	mnk	ሚንክ
cent	mʔt	ሚእቲ
weight	mzn	ሚዛን
symmetry	mzn	ሚዛን
perspective	mzn	ሚዛን
balance	mzn	ሚዛን
appraisal	mzn	ሚዛን
measurement	mzn	ሚዛን
salary	mhj	ማሃያ
wit	mlt	ማለት
undergarment	mlj	ማልያ
oath	mħl	ማሕላ
spark	mħt	ማሕታ
mammoth	mmz	ማሞዝ
capture	mrx	ማረኸ
take	mrx	ማረኸ
arrest	mrx	ማረኸ
output	mrt	ማሪት
magnet	mrx	ማራኺ
gear	mrʃ	ማርሻ
label	mrk	ማርካ
marina	mrn	ማሮኒ
pine	msn	ማሰነ
musk	msk	ማስክ
crank	mnk	ማኒኮ
crux	mnt	ማንታ
twin	mnt	ማንታ
core	mnt	ማንታ
keynote	mnt	ማንታ
meat	mnt	ማንታ
gist	mnt	ማንታ
ladle	mnk	ማንካ
smudge	mkj	ማኪያ
macro	mkr	ማክሮ
honey	mʕr	ማዓር
equivalent	mʕr	ማዕረ
par	mʕr	ማዕረ
level	mʕr	ማዕረ
offing	mʕd	ማዕዶ
door	mʕt͡sʼ	ማዕጾ
goal	mʕt͡sʼ	ማዕጾ
gate	mʕt͡sʼ	ማዕጾ
mile	mjl	ማይል
mime	mjm	ማይም
mica	mjk	ማይካ
major	md͡ʒr	ማጆር
muffin	mfn	ማፊን
kiln	mftʼ	ማፍጢ
meter	mtr	ሜተር
meter	mtr	ሜትሮ
subway	mtr	ሜትሮ
scholar	mhr	ምሁር
colt	mhr	ምሂር
foal	mhr	ምሂር
creation	mhz	ምህዞ
invention	mhz	ምህዞ
fiction	mhz	ምህዞ
whole	mlʔ	ምሉእ
main	mlʔ	ምሉእ
fat	mlʔ	ምሉእ
round	mlʔ	ምሉእ
lot	mlʔ	ምሉእ
response	mlʃ	ምላሽ
reply	mlʃ	ምላሽ
replication	mlʃ	ምላሽ
ejaculation	mlqʰʷ	ምላቝ
transcription	mlʔ	ምላእ
skein	mlq	ምልቆ
pregnancy	mlʔ	ምልኦ
dictatorship	mlk	ምልኪ
vampire	mlk	ምሎክ
retention	mħz	ምሓዝ
attachment	mħz	ምሓዝ
censorship	mmj	ምምያ
acrimony	mrt	ምረት
acrimony	mrr	ምሩር
elect	mrt͡sʼ	ምሩጽ
choice	mrt͡sʼ	ምሩጽ
graduation	mrqʰ	ምራቐ
saliva	mrqʰ	ምራቕ
rust	mrt	ምራተ
thong	mrn	ምራን
strap	mrn	ምራን
marc	mrx	ምራኸ
calf	mrx	ምራኽ
contamination	mrz	ምራዘ
benediction	mrqʰ	ምርቓ
attraction	mrk	ምርኮ
booty	mrk	ምርኮ
trophy	mrk	ምርኮ
sap	mrw	ምርዋ
preference	mrt͡ʃʼ	ምርጫ
predilection	mrt͡ʃʼ	ምርጫ
alternative	mrt͡ʃʼ	ምርጫ
selection	mrt͡ʃʼ	ምርጫ
choice	mrt͡ʃʼ	ምርጫ
poll	mrt͡ʃʼ	ምርጫ
ballot	mrt͡ʃʼ	ምርጫ
election	mrt͡ʃʼ	ምርጫ
option	mrt͡ʃʼ	ምርጫ
metaphor	msl	ምሳሌ
paragon	msl	ምሳሌ
dictum	msl	ምሳሌ
lunch	msħ	ምሳሕ
parcel	msħ	ምሳሕ
image	msl	ምስሊ
adage	msl	ምስላ
image	msl	ምስላ
dictum	msl	ምስላ
dark	mʃt	ምሸት
night	mʃt	ምሸት
designation	mʃm	ምሻም
sale	mʃtʼ	ምሻጥ
sweet	mqr	ምቁር
nectar	mqr	ምቁር
partition	mql	ምቃል
division	mql	ምቃል
fraction	mql	ምቃል
section	mql	ምቃል
clip	mqʰs	ምቕሶ
establishment	mqʰʷm	ምቛም
construction	mqʰʷm	ምቛም
convenience	mt͡ʃʔ	ምቹእ
nice	mt͡ʃʔ	ምቹእ
fit	mt͡ʃʔ	ምቹእ
civilization	mt͡ʃt	ምቾት
comfort	mt͡ʃt	ምቾት
renunciation	mnn	ምነና
arm	mnt	ምናት
well	mnt͡ʃʼ	ምንጪ
origin	mnt͡ʃʼ	ምንጪ
asset	mnt͡ʃʼ	ምንጪ
fount	mnt͡ʃʼ	ምንጪ
font	mnt͡ʃʼ	ምንጪ
source	mnt͡ʃʼ	ምንጪ
fountain	mnt͡ʃʼ	ምንጪ
situation	mkn	ምከና
veteran	mkr	ምኩር
expert	mkr	ምኩር
sage	mkr	ምኩር
stag	mkt	ምክት
hog	mkt	ምክት
experiment	mkr	ምኮራ
miscarriage	mxd	ምኻድ
departure	mxd	ምኻድ
advice	mxr	ምኽሪ
homily	mxr	ምኽሪ
guidance	mxr	ምኽሪ
counsel	mxr	ምኽሪ
prescription	mxr	ምኽሪ
auto	mxʷn	ምዀነ
automobile	mxʷn	ምዀነ
cavalcade	mxʷn	ምዀነ
motor	mxʷn	ምዀነ
car	mxʷn	ምዀነ
machine	mxʷn	ምዀነ
dead	mwt	ምውት
sweet	mʕz	ምዑዝ
advice	mʕd	ምዕዶ
lecture	mʕd	ምዕዶ
counsel	mʕd	ምዕዶ
drain	mʕɡ	ምዕጎ
politic	mzn	ምዙን
classification	mdb	ምደባ
placement	mdb	ምደባ
classification	mdb	ምዳበ
earth	mdr	ምድሪ
ground	mdr	ምድሪ
territory	mdr	ምድሪ
category	mdb	ምድብ
class	mdb	ምድብ
rank	mdb	ምድብ
rating	mdb	ምድብ
brazier	mdd͡ʒ	ምድጃ
logic	mɡt	ምጉት
litigation	mɡʷt	ምጕት
lawsuit	mɡʷt	ምጕት
controversy	mɡʷt	ምጕት
regulation	mtʼn	ምጣነ
seduction	mt͡ʃʼw	ምጫወ
moral	mrl	ሞራል
planet	mrs	ሞርስ
morocco	mrk	ሞሮኮ
offer	mbʔ	ሞባእ
engine	mtr	ሞተረ
motor	mtr	ሞተር
engine	mtr	ሞተር
motor	mtr	ሞቶር
engine	mtr	ሞቶር
thump	mxd	ሞኸደ
status	mjw	ሞያዊ
professional	mjw	ሞያዊ
practitioner	mjw	ሞያዊ
pro	mjw	ሞያዊ
hammer	mdʃ	ሞደ'ሸ
model	mdl	ሞደል
hammer	mdʃ	ሞደሻ
mallet	mdʃ	ሞዶሻ
praise	mɡs	ሞገስ
cylinder	mɡʔ	ሞጉእ
trustee	mɡz	ሞግዚ
caretaker	mɡz	ሞግዚ
eulogy	mɡs	ሞጎስ
sweat	rht͡sʼ	ረሃጽ
array	rmm	ረመመ
rhythm	rmt	ረምታ
barrage	rmt	ረምታ
lull	rrw	ረረወ
glow	rsn	ረሰነ
hog	rsħ	ረሳሕ
pig	rsħ	ረሳሕ
foul	rsħ	ረሳሕ
randy	rsn	ረሳን
heat	rsn	ረስኒ
excitement	rsn	ረስኒ
fever	rsn	ረስኒ
bid	rqʰħ	ረቑሐ
ghost	rqʰqʰ	ረቒቕ
factor	rqʰʷħ	ረቛሒ
bidder	rqʰʷħ	ረቛሒ
badger	rbt͡sʼ	ረበጸ
wednesday	rbʕ	ረቡዕ
beneficiary	rbħ	ረባሒ
urchin	rbʃ	ረባሺ
advantage	rbħ	ረብሓ
profit	rbħ	ረብሓ
vantage	rbħ	ረብሓ
agitation	rbʃ	ረብሻ
retina	rtn	ረቲና
win	rtʕ	ረትዐ
espy	rʔj	ረኣየ
spy	rʔj	ረኣየ
eye	rʔj	ረኣየ
visit	rʔj	ረኣየ
knit	rkm	ረከመ
taint	rxs	ረኸሰ
gain	rxb	ረኸበ
revere	rxb	ረኸበ
hit	rxb	ረኸበ
command	rxb	ረኸበ
find	rxb	ረኸበ
finder	rxb	ረኻቢ
panic	rʕd	ረዓደ
deputy	rdt	ረዳት
reinforcement	rdt	ረዳት
aide	rdt	ረዳት
assistant	rdt	ረዳት
mate	rdt	ረዳት
relief	rdt	ረዳት
aid	rdʔ	ረድአ
assist	rdʔ	ረድአ
reggae	rɡj	ረገይ
oppressor	rɡt͡sʼ	ረገጸ
kick	rɡħ	ረግሐ
freeze	rɡʔ	ረግአ
carrier	rfʕ	ረፋዕ
porter	rfʕ	ረፋዕ
morning	rfd	ረፍዲ
roulette	rlt	ሩለት
purr	rrt	ሩርታ
russia	rsj	ሩስያ
yogurt	rɡʔ	ሩግኦ
pool	rhj	ራህያ
pond	rhj	ራህያ
moisture	rħs	ራሕሲ
ground	rħq	ራሕቂ
nakedness	rqʰt	ራቖት
nudity	rqʰt	ራቖት
vision	rʔj	ራእይ
revelation	rʔj	ራእይ
panic	rʕd	ራዕዲ
terror	rʕd	ራዕዲ
funk	rʕd	ራዕዲ
horror	rʕd	ራዕዲ
rice	rjs	ራይስ
radio	rdj	ራዲዮ
radar	rdr	ራዳር
chassis	rdj	ራድዮ
transmission	rdj	ራድዮ
wireless	rdj	ራድዮ
radio	rdj	ራድዮ
rugby	rɡb	ራግቢ
sweat	rht͡sʼ	ርሀጽ
broad	rħb	ርሒብ
patrimony	rsqʰ	ርሰቓ
pencil	rss	ርሳስ
forgetting	rsʕ	ርሳዐ
forgetfulness	rsʕ	ርሳዐ
limbo	rsʕ	ርሳዕ
manor	rst	ርስቲ
domain	rst	ርስቲ
house	rʃn	ርሻን
building	rʃn	ርሻን
perturbation	rbʃ	ርበሻ
multiple	rbħ	ርባሕ
product	rbħ	ርባሕ
quarter	rbʕ	ርብዒ
assignment	rtb	ርተባ
reason	rtʕ	ርትዒ
self	rʔs	ርእሰ
head	rʔs	ርእሲ
nut	rʔs	ርእሲ
pate	rʔs	ርእሲ
risk	rks	ርከሳ
pool	rks	ርኩስ
opulence	rkb	ርካብ
communication	rkb	ርክብ
contact	rkb	ርክብ
liaison	rkb	ርክብ
relevance	rkb	ርክብ
association	rkb	ርክብ
meeting	rkb	ርክብ
tryst	rkb	ርክብ
magnate	rxb	ርኹብ
opulence	rxb	ርኻብ
beast	rɡm	ርጉም
stable	rɡʔ	ርጉእ
quiet	rɡʔ	ርጉእ
thickness	rɡd	ርጉዲ
gauge	rɡd	ርጉዲ
pigeon	rɡb	ርግቢ
curd	rɡʔ	ርግኦ
percussion	rt͡sʼm	ርጽ'ም
pomegranate	rmn	ሮማን
Wednesday	rbʕ	ሮቡዕ
robin	rbn	ሮቢን
gull	rbr	ሮብራ
robot	rbt	ሮቦት
automation	rbt	ሮቦት
rand	rnd	ሮንዳ
missile	rkt	ሮኬት
rocket	rkt	ሮኬት
rosette	rzt	ሮዘት
swing	sll	ሰለል
seesaw	sll	ሰለል
deck	slm	ሰለመ
gem	slm	ሰለመ
garnish	slm	ሰለመ
prank	slm	ሰለመ
award	slm	ሰለመ
tool	slm	ሰለመ
triple	sls	ሰለሰ
slide	slxʷ	ሰለዀ
scout	slj	ሰለየ
spy	slj	ሰለየ
leg	slf	ሰለፍ
thigh	slf	ሰለፍ
tuesday	sls	ሰሉስ
trio	sls	ሰሉስ
peace	slm	ሰላም
plant	slj	ሰላዪ
detective	slj	ሰላዪ
espionage	slj	ሰላዪ
spy	slj	ሰላዪ
agent	slj	ሰላይ
lettuce	sltʼ	ሰላጣ
salad	sltʼ	ሰላጣ
table	sld	ሰሌዳ
blackboard	sld	ሰሌዳ
plate	sld	ሰሌዳ
scale	sld	ሰሌዳ
trestle	sld	ሰሌዳ
board	sld	ሰሌዳ
quagmire	slm	ሰልሚ
mire	slm	ሰልሚ
morass	slm	ሰልሚ
money	sld	ሰልዲ
coin	sld	ሰልዲ
brass	sld	ሰልዲ
laugh	sħqʰ	ሰሓቐ
allure	sħb	ሰሓበ
tow	sħb	ሰሓበ
tug	sħb	ሰሓበ
draw	sħb	ሰሓበ
recall	sħb	ሰሓበ
miss	sħt	ሰሓተ
tack	smr	ሰመ'ረ
soap	smn	ሰመነ
bid	smj	ሰመየ
mention	smj	ሰመየ
call	smj	ሰመየ
week	smn	ሰሙን
auditor	smʕ	ሰማዒ
hearer	smj	ሰማያ
listener	smj	ሰማያ
heaven	smj	ሰማይ
sky	smj	ሰማይ
north	smn	ሰሜን
wax	smʕ	ሰምዐ
listen	smʕ	ሰምዐ
base	srt	ሰረ'ተ
bone	srqʰ	ሰረቐ
rob	srqʰ	ሰረቐ
sneak	srqʰ	ሰረቐ
steal	srqʰ	ሰረቐ
base	srt	ሰረተ
build	srt	ሰረተ
basis	srt	ሰረት
stronghold	srt	ሰረት
foundation	srt	ሰረት
heredity	srt	ሰረት
gene	srt	ሰረት
survival	srt	ሰረት
groundwork	srt	ሰረት
repeal	srz	ሰረዘ
maker	srħ	ሰራሒ
wright	srħ	ሰራሒ
rider	srr	ሰራሪ
burglar	srqʰ	ሰራቒ
penitentiary	srj	ሰራዪ
manufacture	srħ	ሰርሐ
make	srħ	ሰርሐ
produce	srħ	ሰርሐ
act	srħ	ሰርሐ
function	srħ	ሰርሐ
nostril	srn	ሰርኖ
file	srʕ	ሰርዐ
range	srʕ	ሰርዐ
herb	ssɡ	ሰሰግ
gazelle	ssħ	ሰስሓ
poster	sqʰl	ሰቓሊ
break	sbr	ሰበረ
dash	sbr	ሰበረ
moss	sbb	ሰበባ
baize	sbn	ሰበን
indictment	sbx	ሰበኻ
parish	sbx	ሰበኻ
province	sbx	ሰበኻ
breaker	sbr	ሰባሪ
people	sbt	ሰባት
multiple	sbt	ሰባት
missionary	sbx	ሰባኺ
seventy	sbʕ	ሰብዓ
disc	stt	ሰተታ
disk	stt	ሰተታ
drink	stj	ሰተየ
alcoholic	stj	ሰታይ
senate	snt	ሰነት
paper	snd	ሰነድ
document	snd	ሰነድ
wolf	snɡ	ሰነገ
monday	snj	ሰኑይ
manufacturer	snʕ	ሰናዒ
produce	snʕ	ሰንዐ
manufacture	snʕ	ሰንዐ
penknife	sntʼ	ሰንጢ
paint	sʔl	ሰኣለ
trace	sʔl	ሰኣለ
film	sʔl	ሰኣለ
illustrator	sʔl	ሰኣሊ
photographer	sʔl	ሰኣሊ
lack	sʔn	ሰኣነ
miss	sʔn	ሰኣነ
schema	skm	ሰከም
load	skm	ሰከም
insert	sxʷʕ	ሰዅዐ
stud	sxʷʕ	ሰዅዐ
revolution	swr	ሰዉራ
grass	swħ	ሰውሒ
revolution	swr	ሰውራ
cough	sʕl	ሰዓል
coughing	sʕl	ሰዓል
kiss	sʕm	ሰዓመ
defeat	sʕr	ሰዓረ
win	sʕr	ሰዓረ
victor	sʕr	ሰዓሪ
tail	sʕb	ሰዓበ
result	sʕb	ሰዓበ
adherent	sʕb	ሰዓቢ
satellite	sʕb	ሰዓቢ
follower	sʕb	ሰዓቢ
pointer	sʕt	ሰዓት
watch	sʕt	ሰዓት
time	sʕt	ሰዓት
hour	sʕt	ሰዓት
term	sjm	ሰየመ
slope	sjf	ሰያፍ
sage	sjd͡ʒ	ሰይጅ
bench	sdqʰ	ሰደቓ
bureau	sdqʰ	ሰደቓ
desk	sdqʰ	ሰደቓ
celery	sdn	ሰደኖ
dispatch	sdd	ሰደደ
post	sdd	ሰደደ
export	sdd	ሰደደ
export	sdd	ሰደድ
butt	sdf	ሰደፍ
transmitter	sdd	ሰዳዲ
celery	sdn	ሰዴኖ
chair	sdj	ሰድያ
ford	sɡr	ሰገረ
trans	sɡr	ሰገር
sheath	sɡb	ሰገባ
scabbard	sɡb	ሰገባ
ostrich	sɡn	ሰገን
bow	sɡd	ሰገደ
lock	sɡtʼ	ሰጋጥ
flood gate	sɡtʼ	ሰጋጥ
fear	sɡʔ	ሰግአ
step	sɡm	ሰጎመ
kick	sɡɡ	ሰጎገ
pace	sɡʷm	ሰጐመ
advance	sɡʷm	ሰጐመ
lock	stʼm	ሰጠመ
display	stʼħ	ሰጥሓ
roost	sfr	ሰፈረ
location	sfr	ሰፈር
habitat	sfr	ሰፈር
case	sfr	ሰፈር
camp	sfr	ሰፈር
nest	sfr	ሰፈር
sheath	sfr	ሰፈር
stitch	sfj	ሰፈየ
cruise	sff	ሰፈፈ
scud	sff	ሰፈፈ
wax	sff	ሰፈፍ
broad	sfħ	ሰፊሕ
ocean	sfħ	ሰፊሕ
squatter	sfr	ሰፋሪ
settler	sfr	ሰፋሪ
navigator	sff	ሰፋፊ
aerial	sff	ሰፋፊ
float	sff	ሰፋፊ
participation	stf	ሱታፌ
silica	slk	ሲሊካ
siren	srn	ሲረና
civilian	svl	ሲቪል
movie	snm	ሲነማ
studio	snm	ሲነማ
cinema	snm	ሲነማ
cynic	snk	ሲኒክ
underworld	sʔl	ሲኦል
sierra	sjr	ሲያራ
cedar	sdr	ሲዳር
motif	slm	ሳላሚ
lettuce	sltʼ	ሳላጣ
salad	sltʼ	ሳላጣ
salon	sln	ሳሎን
sofa	sln	ሳሎን
laughter	sħqʰ	ሳሓቕ
frolic	sħq	ሳሕቂ
soap	smn	ሳሙና
samba	smb	ሳምባ
tablet	smn	ሳምና
tombstone	smʕ	ሳምዕ
rocket	srx	ሳሩኽ
spider	srt	ሳሬት
serum	srm	ሳርማ
cereal	sbl	ሳብል
sable	sbl	ሳብል
satin	stn	ሳቲን
bayonet	snd͡ʒ	ሳንጃ
bag	sntʼ	ሳንጣ
valise	sntʼ	ሳንጣ
case	sntʼ	ሳንጣ
satchel	sntʼ	ሳንጣ
shoe	sʔn	ሳእኒ
oats	sʕʕ	ሳዓዕ
thatch	sʕr	ሳዕሪ
forage	sʕr	ሳዕሪ
grass	sʕr	ሳዕሪ
sine	sjn	ሳይን
carpet	sjd	ሳይደ
sedan	sdɲ	ሳደኛ
maiden	sdl	ሳዱላ
box	st͡sʼn	ሳጹን
canister	st͡sʼn	ሳጹን
container	st͡sʼn	ሳጹን
crate	st͡sʼn	ሳጹን
safari	sfr	ሳፋሪ
spider	sft	ሳፌት
intelligence	sll	ስለላ
espionage	sll	ስለላ
patrol	sll	ስለላ
triple	sls	ስሉስ
victim	slb	ስሉብ
booty	slb	ስሉብ
sloth	slz	ስሉዝ
sloop	slp	ስሉፕ
trinity	sls	ስላሴ
goad	slʕ	ስላዕ
slug	slɡ	ስላግ
pattern	slm	ስልመ
sauce	sls	ስልሲ
tactics	slt	ስልቲ
telephone	slk	ስልኪ
wire	slk	ስልኪ
laugh	sħqʰ	ስሓቕ
pull	sħb	ስሓበ
basin	sħn	ስሓኒ
bidder	smj	ስሙይ
contamination	smm	ስማመ
smack	smk	ስማክ
bidder	smj	ስማይ
citation	smt	ስሜታ
wax	smʕ	ስምዒ
mention	smj	ስምያ
repeal	srz	ስረዛ
instant	srħ	ስሩሕ
activity	srħ	ስራሕ
labor	srħ	ስራሕ
preoccupation	srħ	ስራሕ
job	srħ	ስራሕ
function	srħ	ስራሕ
occupation	srħ	ስራሕ
employment	srħ	ስራሕ
situation	srħ	ስራሕ
work	srħ	ስራሕ
trade	srħ	ስራሕ
charm	srj	ስራይ
remission	srt	ስሬት
larceny	srq	ስርቂ
felony	srq	ስርቂ
theft	srq	ስርቂ
swindle	srq	ስርቂ
sinus	srn	ስርኖ
vulture	ssʕ	ስሱዕ
pig	ssʕ	ስሱዕ
hog	ssʕ	ስሱዕ
egoism	ssʕ	ስስዐ
ostracism	sqt	ስቀት
cross	sqʰj	ስቓይ
heartache	sqʰj	ስቓይ
torture	sqʰj	ስቓይ
fat	sbħ	ስቡሕ
fracture	sbr	ስባር
rubble	sbr	ስባር
grease	sbħ	ስብሒ
fat	sbħ	ስብሒ
lard	sbħ	ስብሒ
cream	sbq	ስብቆ
private	str	ስቱር
stucco	stk	ስቱኮ
cripple	snf	ስኑፍ
harmony	snt	ስኒት
oneness	snt	ስኒት
agreement	snt	ስኒት
accordance	snt	ስኒት
compatibility	snt	ስኒት
concord	snt	ስኒት
tune	snt	ስኒት
cosmos	snt	ስኒት
provision	snq	ስንቂ
profile	sʔl	ስኣለ
image	sʔl	ስእሊ
painting	sʔl	ስእሊ
figure	sʔl	ስእሊ
portrait	sʔl	ስእሊ
photo	sʔl	ስእሊ
photograph	sʔl	ስእሊ
picture	sʔl	ስእሊ
illustration	sʔl	ስእሊ
drawing	sʔl	ስእሊ
skate	skt	ስኬት
insertion	skʷʕ	ስኳዕ
swan	swn	ስዋን
occult	swr	ስውር
jargon	swj	ስውይ
loser	sʕr	ስዑር
adherent	sʕb	ስዓቢ
nomination	sjm	ስዩም
nominee	sjm	ስዩም
terminology	sjm	ስያመ
nomination	sjm	ስያመ
bank	sjf	ስያፍ
cant	sjf	ስያፍ
deflection	sjt	ስይታ
emigration	sdt	ስደት
exodus	sdt	ስደት
immigration	sdt	ስደት
span	sdr	ስድሪ
household	sdr	ስድራ
home	sdr	ስድራ
family	sdr	ስድራ
barley	sɡm	ስገም
step	sɡm	ስጉሚ
latch	sɡtʼ	ስጋጥ
pace	sɡʷm	ስጓመ
radical	sɡʷm	ስጓማ
flat	stʼħ	ስጡሕ
stitch	sfj	ስፋ'ይ
seam	sfj	ስፋይ
stitch	sft	ስፌት
site	sfr	ስፍራ
place	sfr	ስፍራ
bridge	srn	ሶርኖ
sonnet	snt	ሶነት
sonata	snt	ሶናታ
bayonet	snk	ሶንኪ
fawn	ʃħr	ሸሓረ
plate	ʃħn	ሸሓኒ
cajole	ʃħtʼ	ሸሓጠ
butter	ʃħtʼ	ሸሓጠ
demagogue	ʃħtʼ	ሸሓጢ
garlic	ʃmt	ሸመታ
windmill	ʃrr	ሸረሮ
nick	ʃrf	ሸረፈ
bin	ʃrf	ሸሩፍ
tape	ʃrtʼ	ሸሪጥ
ribbon	ʃrtʼ	ሸሪጥ
nick	ʃrf	ሸራፍ
pap	ʃrb	ሸርበ
cholera	ʃrx	ሸሮኽ
proletariat	ʃql	ሸቃሎ
sting	ʃqt	ሸቅታ
prick	ʃqt	ሸቅታ
trade	ʃqʰtʼ	ሸቐጥ
merchandise	ʃqʰtʼ	ሸቐጥ
twinge	ʃqʰt	ሸቕታ
prick	ʃqʰt	ሸቕታ
slipper	ʃbtʼ	ሸበጥ
value	ʃnn	ሸነነ
side	ʃnx	ሸነኽ
rating	ʃnn	ሸናኒ
burden	ʃkm	ሸከም
sprint	ʃkʷxʷ	ሸኰዀ
dig	ʃxl	ሸኸለ
scorch	ʃxxʷ	ሸኾዅ
flurry	ʃwt	ሸውታ
seller	ʃjtʼ	ሸያጢ
vendor	ʃjtʼ	ሸያጢ
salesman	ʃjtʼ	ሸያጢ
clerk	ʃjtʼ	ሸያጢ
lock	ʃɡtʼ	ሸገጠ
lock	ʃɡr	ሸጎረ
tuck	ʃɡtʼ	ሸጎጠ
latch	ʃɡʷr	ሸጐረ
veneer	ʃfn	ሸፈነ
wrap	ʃfn	ሸፈነ
cap	ʃfn	ሸፈነ
fold	ʃfn	ሸፈነ
lap	ʃfn	ሸፈነ
coat	ʃfn	ሸፈነ
cocoon	ʃfn	ሸፈነ
mask	ʃfn	ሸፈነ
dishonesty	ʃftʼ	ሸፈጥ
malpractice	ʃftʼ	ሸፈጥ
skim	ʃff	ሸፈፈ
chieftain	ʃmɲ	ሹመኛ
dignitary	ʃmɲ	ሹመኛ
chamois	ʃmw	ሻምዋ
asparagus	ʃmt	ሻሞት
partisan	ʃrɲ	ሻረኛ
muffler	ʃrb	ሻርባ
slipper	ʃbt	ሻባቶ
sprig	ʃbtʼ	ሻቦጥ
switch	ʃbtʼ	ሻቦጥ
tack	ʃll	ሽላ'ሎ
disc	ʃħn	ሽሓኒ
disk	ʃħn	ሽሓኒ
incantation	ʃħr	ሽሕር
appointment	ʃmt	ሽመት
success	ʃmt	ሽመት
candle	ʃmʕ	ሽምዓ
groin	ʃmtʼ	ሽምጢ
loin	ʃmtʼ	ሽምጢ
canvas	ʃrʕ	ሽራዕ
band	ʃrtʼ	ሽራጥ
bar	ʃrtʼ	ሽራጥ
stripe	ʃrtʼ	ሽራጥ
associate	ʃrk	ሽርካ
partner	ʃrk	ሽርካ
breach	ʃrf	ሽሮፍ
syrup	ʃrp	ሽሮፖ
hiss	ʃʃt	ሽሽታ
drainage	ʃqqʰ	ሽቃቕ
toilet	ʃqʰqʰ	ሽቓቕ
hiatus	ʃbr	ሽበራ
terrorism	ʃbr	ሽበራ
terror	ʃbr	ሽበራ
soap	ʃbn	ሽበን
stylus	ʃtl	ሽቶል
pod	ʃtl	ሽቶል
estimate	ʃnn	ሽነና
determination	ʃnn	ሽነና
estimation	ʃnn	ሽነና
piss	ʃnt	ሽንቲ
urine	ʃnt	ሽንቲ
evaluation	ʃnn	ሽንን
appraisal	ʃnn	ሽንን
sonnet	ʃntʼ	ሽንጢ
sanitation	ʃntʼ	ሽንጢ
sugar	ʃkr	ሽኮር
sugar	ʃkʷr	ሽኰር
picket	ʃxl	ሽኻል
stake	ʃxl	ሽኻል
hoof	ʃxn	ሽኾና
circulation	ʃjtʼ	ሽያጥ
cigarette	ʃɡr	ሽጋራ
difficulty	ʃɡr	ሽግር
complexity	ʃɡr	ሽግር
mire	ʃɡr	ሽግር
problem	ʃɡr	ሽግር
hoax	ʃtʼr	ሽጣራ
trick	ʃtʼr	ሽጣራ
artifice	ʃtʼr	ሽጣራ
cheat	ʃtʼr	ሽጣራ
veneer	ʃfn	ሽፋን
rug	ʃfn	ሽፋን
coat	ʃfn	ሽፋን
membrane	ʃfn	ሽፋን
sheath	ʃfn	ሽፋን
cocoon	ʃfn	ሽፋን
bandit	ʃft	ሽፍታ
outlaw	ʃft	ሽፍታ
peter	qhm	ቀሃመ
ink	qlm	ቀለመ
paint	qlm	ቀለም
colour	qlm	ቀለም
ink	qlm	ቀለም
polish	qlm	ቀለም
food	qlb	ቀለብ
fry	qlw	ቀለወ
skin	qltʼ	ቀለጠ
strip	qltʼ	ቀለጠ
peel	qltʼ	ቀለጠ
plain	qll	ቀሊል
picnic	qll	ቀሊል
armature	qls	ቀላ'ሲ
pivot	qls	ቀላሲ
differential	qls	ቀላሲ
feeder	qlb	ቀላቢ
lake	qlj	ቀላይ
heart	qlb	ቀልቢ
retention	qlb	ቀልቢ
sense	qlb	ቀልቢ
thought	qlb	ቀልቢ
consciousness	qlb	ቀልቢ
punt	qlʕ	ቀልዐ
bat	qlʕ	ቀልዐ
tee	qlʕ	ቀልዐ
boot	qlʕ	ቀልዐ
umbrage	qħr	ቀሓር
spice	qmm	ቀመም
computation	qmr	ቀመር
nave	qmr	ቀመር
calculation	qmr	ቀመር
formula	qmr	ቀመር
cupola	qmr	ቀመር
tunic	qms	ቀሚስ
skirt	qms	ቀሚስ
cloth	qms	ቀሚስ
cloth	qmʃ	ቀሚሽ
chemist	qmm	ቀማ'ሚ
gourmet	qms	ቀማሲ
dress	qmʃ	ቀምሽ
nap	qmt	ቀምታ
approach	qrb	ቀረበ
help	qrb	ቀረበ
supply	qrb	ቀረበ
close	qrb	ቀረባ
stock	qrb	ቀረብ
supply	qrb	ቀረብ
throw	qrt͡sʼ	ቀረጸ
chase	qrt͡sʼ	ቀረጸ
sculpture	qrt͡sʼ	ቀረጸ
shape	qrt͡sʼ	ቀረጸ
tariff	qrt͡sʼ	ቀረጽ
toll	qrt͡sʼ	ቀረጽ
tax	qrt͡sʼ	ቀረጽ
duty	qrt͡sʼ	ቀረጽ
rate	qrt͡sʼ	ቀረጽ
excise	qrt͡sʼ	ቀረጽ
taxation	qrt͡sʼ	ቀረጽ
hull	qrf	ቀረፈ
peel	qrf	ቀረፈ
scale	qrf	ቀረፈ
stubble	qrm	ቀሪም
horn	qrn	ቀርኒ
compulsion	qsb	ቀስቢ
coercion	qsb	ቀስቢ
obligation	qsb	ቀስቢ
constraint	qsb	ቀስቢ
arch	qst	ቀስተ
arc	qst	ቀስቲ
crossbow	qst	ቀስቲ
vault	qst	ቀስቲ
bow	qst	ቀስቲ
tinder	qʃm	ቀሸም
maple	qqb	ቀቁብ
cortege	qbr	ቀበረ
tribe	qbl	ቀቢላ
township	qbl	ቀቢላ
funeral	qbr	ቀብሪ
grease	qbʔ	ቀብአ
kill	qtl	ቀተለ
warp	qnn	ቀነነ
list	qnn	ቀነነ
tilt	qnn	ቀነነ
slant	qnn	ቀነነ
principal	qnd	ቀንዲ
prime	qnd	ቀንዲ
grand	qnd	ቀንዲ
chief	qnd	ቀንዲ
veto	qwf	ቀወፈ
static	qwm	ቀዋሚ
crisis	qws	ቀውሲ
harvest	qwʕ	ቀውዒ
autumn	qwʕ	ቀውዒ
veto	qwf	ቀውፊ
propeller	qzf	ቀዛፊ
transform	qjr	ቀየረ
shift	qjr	ቀየረ
change	qjr	ቀየረ
convert	qjr	ቀየረ
transfer	qjr	ቀየረ
survey	qjs	ቀየሰ
converter	qjr	ቀያሪ
prisoner	qjd	ቀያዲ
restriction	qjd	ቀያዲ
red	qjħ	ቀይሕ
detention	qjd	ቀይዲ
pass	qdm	ቀደመ
advance	qdm	ቀደመ
past	qdm	ቀደም
tear	qdd	ቀደደ
pick	qdd	ቀደደ
cut	qdd	ቀደደ
rip	qdd	ቀደደ
saturday	qdm	ቀዳም
cutter	qdd	ቀዳዲ
loophole	qdd	ቀዳድ
slit	qdd	ቀዳድ
slot	qdd	ቀዳድ
puncture	qdd	ቀዳድ
trace	qdħ	ቀድሐ
tape	qdħ	ቀድሐ
pump	qdħ	ቀድሐ
method	qtʼʕ	ቀጥዒ
system	qtʼʕ	ቀጥዒ
way	qtʼʕ	ቀጥዒ
resume	qt͡sʼl	ቀጸለ
keep	qt͡sʼl	ቀጸለ
go	qt͡sʼl	ቀጸለ
thickness	qt͡sʼl	ቀጸላ
stratum	qt͡sʼl	ቀጸላ
plate	qt͡sʼl	ቀጸላ
slab	qt͡sʼl	ቀጸላ
glut	qt͡sʼt͡sʼ	ቀጸጸ
competition	qt͡sʼt͡sʼ	ቀጸጸ
barrage	qt͡sʼl	ቀጻሊ
constant	qt͡sʼl	ቀጻሊ
bailey	qt͡sʼr	ቀጽሪ
guard	qfr	ቀፊር
curry	qlw	ቁልዋ
belt	qlf	ቁልፊ
height	qmt	ቁመት
louse	qml	ቁማል
drop	qrb	ቁሩብ
little	qrb	ቁሩብ
bit	qrs	ቁራስ
pot	qrʕ	ቁራዕ
piece	qrt͡sʼ	ቁራጽ
chip	qrt͡sʼ	ቁራጽ
breakfast	qrs	ቁርሲ
sculpture	qrt͡sʼ	ቁርጺ
ulcer	qsl	ቁስሊ
pueblo	qʃt	ቁሸት
village	qʃt	ቁሸት
reel	qnn	ቁኒን
flea	qnt͡ʃʼ	ቁንጪ
exasperation	qtʼʕ	ቁጠዐ
ire	qtʼʕ	ቁጠዐ
rage	qtʼʕ	ቁጠዓ
bile	qtʼʕ	ቁጡዕ
thrift	qtʼb	ቁጣበ
allergy	qtʼʕ	ቁጥዐ
anger	qtʼʕ	ቁጥዐ
knot	qt͡sʼr	ቁጻር
figure	qt͡sʼr	ቁጽሪ
acrimony	qmt	ቂምታ
venom	qmt	ቂምታ
vocabulary	qlt	ቃላት
tussle	qls	ቃልሲ
combat	qls	ቃልሲ
war	qls	ቃልሲ
struggle	qls	ቃልሲ
glade	qlʕ	ቃልዕ
volition	qħt	ቃሕታ
fork	qrn	ቃራና
stretcher	qrz	ቃሬዛ
gnat	qrm	ቃርማ
hockey	qrs	ቃርሳ
cinnamon	qrf	ቃርፋ
clip	qqʰr	ቃቐረ
pitch	qnj	ቃነየ
pain	qnz	ቃንዛ
twinge	qnz	ቃንዛ
tambourine	qnd	ቃንዳ
coalition	qnd͡ʒ	ቃንጃ
crack	qʕt	ቃዕታ
click	qʕt	ቃዕታ
trigger	qʕt	ቃዕታ
lamb	qʕj	ቃዕያ
heath	qdr	ቃድራ
bell	qt͡ʃʼl	ቃጭል
strip	qt͡sʼʕ	ቃጽዖ
parcel	qt͡sʼʕ	ቃጽዖ
plot	qt͡sʼʕ	ቃጽዖ
acre	qt͡sʼʕ	ቃጽዖ
dalliance	qlt	ቅለት
ignominy	qlt	ቅለት
pittance	qlw	ቅሉው
punt	qlʕ	ቅላዕ
husk	qltʼ	ቅላጥ
flake	qltʼ	ቅላጥ
rind	qltʼ	ቅላጥ
shell	qltʼ	ቅላጥ
frying	qlw	ቅልዋ
reservation	qmtʼ	ቅሙጥ
reserve	qmtʼ	ቅሙጥ
stack	qmtʼ	ቅሚጦ
rick	qmtʼ	ቅሚጦ
haystack	qmtʼ	ቅሚጦ
taste	qms	ቅምሶ
sample	qms	ቅምሶ
offer	qrb	ቅረባ
standing	qrb	ቅሩ'ብ
content	qrb	ቅሩ'ብ
skin	qrf	ቅራፍ
hull	qrf	ቅራፍ
peel	qrf	ቅራፍ
scale	qrf	ቅራፍ
shell	qrf	ቅራፍ
breakfast	qrs	ቅርሲ
dollar	qrʃ	ቅርሺ
grouse	qrt	ቅርታ
polity	qrt͡sʼ	ቅርጺ
form	qrt͡sʼ	ቅርጺ
format	qrt͡sʼ	ቅርጺ
structure	qrt͡sʼ	ቅርጺ
profile	qrt͡sʼ	ቅርጺ
shape	qrt͡sʼ	ቅርጺ
configuration	qrt͡sʼ	ቅርጺ
constraint	qsb	ቅሱብ
husk	qqħ	ቅቃሕ
broth	qql	ቅቅል
audience	qbl	ቅበ'ላ
admittance	qbl	ቅበላ
reception	qbl	ቅበላ
admission	qbl	ቅበላ
receipt	qbl	ቅባለ
acceptance	qbl	ቅባለ
approval	qbl	ቅባለ
commendation	qbl	ቅብላ
ointment	qbʔ	ቅብኢ
rebate	qns	ቅነሳ
discount	qns	ቅነሳ
frank	qnʕ	ቅኑዕ
objective	qnʕ	ቅኑዕ
tone	qnt	ቅኒት
discount	qns	ቅናስ
allowance	qns	ቅናስ
band	qnt	ቅናት
belt	qnt	ቅናት
jaundice	qnʔ	ቅንኢ
constitution	qwm	ቅዋመ
recipe	qwm	ቅዋመ
formula	qwm	ቅዋመ
constitution	qwm	ቅዋም
shift	qjr	ቅየራ
conversion	qjr	ቅየራ
survey	qjs	ቅየሳ
flux	qjr	ቅያረ
mutation	qjr	ቅያር
variety	qjr	ቅያር
transformation	qjr	ቅያር
alternative	qjr	ቅያር
noble	qds	ቅዱስ
saint	qds	ቅዱስ
consultation	qds	ቅዱስ
facsimile	qdħ	ቅዳሕ
travesty	qdħ	ቅዳሕ
replica	qdħ	ቅዳሕ
echo	qdħ	ቅዳሕ
transcript	qdħ	ቅዳሕ
replication	qdħ	ቅዳሕ
edition	qdħ	ቅዳሕ
reproduction	qdħ	ቅዳሕ
copy	qdħ	ቅዳሕ
mass	qds	ቅዳሴ
liturgy	qds	ቅዳሴ
church	qds	ቅዳሴ
framework	qtʼʕ	ቅጥዒ
procedure	qtʼʕ	ቅጥዒ
format	qtʼʕ	ቅጥዒ
manner	qtʼʕ	ቅጥዒ
method	qtʼʕ	ቅጥዒ
decorum	qtʼʕ	ቅጥዒ
combustion	qt͡sʼl	ቅጸላ
good	qt͡sʼʕ	ቅጹዕ
prefix	qt͡sʼl	ቅጽል
belt	qlf	ቆለፈ
infant	qlʕ	ቆልዓ
child	qlʕ	ቆልዓ
louse	qml	ቆማል
gully	qrr	ቆረረ
glen	qrr	ቆረረ
freeze	qrr	ቆረረ
hack	qrt͡sʼ	ቆረጸ
partridge	qqʰħ	ቆቕሕ
partridge	qqʰʷħ	ቆቛሕ
cap	qbʕ	ቆቢዕ
hat	qbʕ	ቆቢዕ
hat	qbʕ	ቆብዕ
hood	qbʕ	ቆብዕ
turban	qbʕ	ቆብዕ
hairdresser	qnn	ቆናኒ
belle	qnd͡ʒ	ቆንጆ
hold	qt͡sʼr	ቆጸረ
date	qt͡sʼr	ቆጸራ
rick	qt͡sʼj	ቆጸየ
meter	qt͡sʼr	ቆጻሪ
counter	qt͡sʼr	ቆጻሪ
leaf	qt͡sʼl	ቆጽሊ
catch	qʷlb	ቈለበ
infant	qʷlʕ	ቈልዓ
child	qʷlʕ	ቈልዓ
kid	qʷlʕ	ቈልዓ
high	qʷmt	ቈማት
cut	qʷrt͡sʼ	ቈረጸ
excise	qʷrt͡sʼ	ቈረጸ
grave	qʷrt͡sʼ	ቈረጸ
chop	qʷrt͡sʼ	ቈረጸ
cold	qʷrr	ቈራሪ
cutter	qʷrt͡sʼ	ቈራጺ
militant	qʷrt͡sʼ	ቈራጽ
ulcer	qʷsl	ቈሰለ
cap	qʷbʕ	ቈብዕ
brawl	qʷjqʰʷ	ቈየቛ
squabble	qʷjqʷ	ቈይቊ
altercation	qʷjqʷ	ቈይቊ
economist	qʷtʼb	ቈጣቢ
account	qʷt͡sʼr	ቈጸረ
enumeration	qʷt͡sʼr	ቈጸራ
appointment	qʷt͡sʼr	ቈጸራ
engagement	qʷt͡sʼr	ቈጸራ
tryst	qʷt͡sʼr	ቈጸራ
count	qʷt͡sʼr	ቈጸራ
employer	qʷt͡sʼr	ቈጻሪ
quack	qʷqʰʷt	ቋቝታ
tongue	qʷnqʷ	ቋንቋ
idiom	qʷnqʷ	ቋንቋ
language	qʷnqʷ	ቋንቋ
hitch	qʷt͡sʼr	ቋጸረ
inch	qʷrb	ቍሩብ
modicum	qʷrb	ቍሩብ
sleeper	qʷrb	ቍሩብ
dissection	qʷrt͡sʼ	ቍራጽ
stub	qʷrt͡sʼ	ቍራጽ
shred	qʷrt͡sʼ	ቍራጽ
package	qʷtʼb	ቍጠባ
thrift	qʷtʼb	ቍጠባ
saving	qʷtʼb	ቍጠባ
economy	qʷtʼb	ቍጠባ
spleen	qʷtʼʕ	ቍጥዐ
rage	qʷtʼʕ	ቍጥዐ
ire	qʷtʼʕ	ቍጥዐ
population	qʷt͡sʼr	ቍጽሪ
number	qʷt͡sʼr	ቍጽሪ
accuracy	qʰnʕ	ቑኑዕ
acquittal	qʰnʕ	ቑኑዕ
alarm	qʰt͡ʃʼl	ቓጭል
children	qʰʷlʕ	ቘልዑ
language	qʰʷnqʰʷ	ቛንቛ
dummy	bhm	በሃም
hero	bhr	በሃር
fancy	bhɡ	በሃገ
aspirant	bhɡ	በሃጊ
revelation	bll	በለለ
cactus	bls	በለስ
ochre	blqʰ	በለቕ
wear	blj	በለየ
ballet	blj	በለየ
outreach	blt͡sʼ	በለጸ
wit	blħ	በሊሕ
sharp	blħ	በሊሕ
mouth	blʕ	በልዐ
fly	brr	በረረ
flight	brr	በረራ
flash	brqʰ	በረቐ
rise	brqʰ	በረቐ
wilderness	brx	በረኻ
freeze	brd	በረደ
ice	brd	በረድ
flier	brr	በራሪ
solvent	brz	በራዚ
shine	brh	በርሀ
glint	brh	በርሀ
flash	brq	በርቂ
cook	bsl	በሰለ
miser	bqqʰ	በቃቕ
reprisal	bqʰl	በቐል
mule	bqʰl	በቕሊ
fit	bqʰʕ	በቕዐ
malt	bqʰʷl	በቘለ
cue	btr	በትሪ
stick	btr	በትሪ
lift	bnn	በነነ
valve	bnn	በናኒ
cry	bxj	በኸየ
crier	bxj	በኻዪ
ferment	bxʷʕ	በዅዐ
festival	bʕl	በዓል
celebration	bʕl	በዓል
holiday	bʕl	በዓል
grotto	bʕt	በዓቲ
cave	bʕt	በዓቲ
den	bʕt	በዓቲ
weld	bjd	በየደ
swap	bdl	በደላ
barter	bdl	በደላ
crime	bdl	በደል
malpractice	bdl	በደል
smallpox	bdd	በዲዶ
foul	bdn	በዳን
dare	bdh	በድሀ
challenge	bdh	በድሀ
stench	bdn	በድኒ
sheep	bɡʕ	በጊዕ
sheep	bɡʕ	በግዕ
slash	btʼħ	በጥሐ
visitor	bt͡sʼħ	በጻሒ
arrival	bt͡sʼħ	በጻሒ
reach	bt͡sʼħ	በጽሐ
turn	bt͡sʼħ	በጽሐ
strike	bt͡sʼħ	በጽሐ
visit	bt͡sʼħ	በጽሐ
call	bt͡sʼħ	በጽሐ
adolescent	bt͡sʼħ	በጽሒ
sacrament	brk	ቡራኬ
benediction	brk	ቡራኬ
mail	bstʼ	ቡስጣ
envelope	bstʼ	ቡስጣ
dial	bsl	ቡሶላ
bushel	bʃl	ቡሸል
malt	bqʰl	ቡቕሊ
yeast	bqʰl	ቡቕሊ
vegetation	bqʰl	ቡቕሊ
brown	bnw	ቡናዊ
paste	bħqʰ	ቢሑቕ
dough	bħqʰ	ቢሑቕ
beer	brr	ቢርራ
beaver	bvr	ቢቨር
bridge	bnt	ቢንቶ
bikini	bkn	ቢኪኒ
saucer	bjt	ቢያቲ
culture	bhl	ባህሊ
tradition	bhl	ባህሊ
personality	bhr	ባህሪ
behaviour	bhr	ባህሪ
kidney	bhr	ባህሪ
propensity	bhr	ባህሪ
desire	bhɡ	ባህጊ
aspiration	bhɡ	ባህጊ
fancy	bhɡ	ባህጊ
balloon	bln	ባሉን
capsule	blq	ባሊቃ
marble	bln	ባሊና
trellis	blt	ባሌቲ
rescue	blh	ባልሀ
parasite	blʕ	ባልዕ
pest	blʕ	ባልዕ
draft	blj	ባልያ
luggage	bld͡ʒ	ባልጃ
valise	bld͡ʒ	ባልጃ
trunk	bld͡ʒ	ባልጃ
suitcase	bld͡ʒ	ባልጃ
whirlpool	bħr	ባሕሪ
shore	bħr	ባሕሪ
blue	bħr	ባሕሪ
sea	bħr	ባሕሪ
stretcher	brl	ባረላ
dig	brw	ባረወ
powder	brd	ባሩድ
booth	brk	ባራካ
eruption	brʕ	ባርዕ
combustion	brʕ	ባርዕ
inferno	brʕ	ባርዕ
conflagration	brʕ	ባርዕ
flame	brʕ	ባርዕ
fire	brʕ	ባርዕ
slave	brj	ባርያ
paste	bst	ባስታ
tub	bsk	ባስካ
railway	bbr	ባቡር
vestibule	bbr	ባቡር
battery	btr	ባተሪ
banana	bnn	ባናና
bank	bnk	ባንክ
counter	bnk	ባንኮ
banjo	bnd͡ʒ	ባንጆ
scrimmage	bʔs	ባእሲ
squabble	bʔs	ባእሲ
tussle	bʔs	ባእሲ
scuffle	bʔs	ባእሲ
account	bʔs	ባእሲ
element	bʔt	ባእታ
item	bʔt	ባእታ
spotlight	bwz	ባውዛ
self	bʕl	ባዕለ
ego	bʕl	ባዕሊ
self	bʕl	ባዕሊ
tartar	bʕk	ባዕኪ
alien	bʕd	ባዕዲ
outsider	bʕd	ባዕዲ
mercury	bzq	ባዚቃ
phonograph	bzq	ባዚቃ
boutique	bzr	ባዛር
bazaar	bzr	ባዛር
mercury	bzq	ባዜቃ
mare	bzr	ባዝራ
deck	bjt	ባይታ
ground	bjt	ባይታ
bed	bjt	ባይታ
bottom	bjt	ባይታ
floor	bjt	ባይታ
parliament	bjt	ባይቶ
forum	bjt	ባይቶ
assembly	bjt	ባይቶ
house	bjt	ባይቶ
shovel	bdl	ባዴላ
pan	bdl	ባዴላ
void	bdm	ባድም
waste	bdm	ባድም
vacuum	bdʃ	ባዶሽ
certificate	bd͡ʒl	ባጀላ
badger	bd͡ʒr	ባጀር
budget	bd͡ʒt	ባጀት
tram	bɡn	ባጎኒ
coach	bɡn	ባጎኒ
van	bɡn	ባጎኒ
wagon	bɡn	ባጎኒ
car	bɡn	ባጎኒ
truck	bɡn	ባጎኒ
pane	btr	ቤትሮ
bacon	bkn	ቤኮን
basil	bzl	ቤዚል
adage	bhl	ብሂል
tradition	bhl	ብሂል
axiom	bhl	ብሂል
dictum	bhl	ብሂል
imbecile	bhm	ብሃም
nation	bhr	ብሄር
allegation	bhl	ብህሎ
antique	blj	ብሉይ
classic	blt͡sʼ	ብሉጽ
prime	blt͡sʼ	ብሉጽ
superior	blt͡sʼ	ብሉጽ
crap	blʃ	ብላሽ
fudge	blʃ	ብላሽ
fiasco	blʃ	ብላሽ
punk	blʃ	ብላሽ
politic	blh	ብልሂ
tip	blħ	ብልሒ
apex	blħ	ብልሒ
spike	blħ	ብልሒ
acumen	blħ	ብልሒ
edge	blħ	ብልሒ
barb	blħ	ብልሒ
blade	blħ	ብልሒ
meal	blʕ	ብልዒ
food	blʕ	ብልዒ
excellence	blt͡ʃʼ	ብልጫ
vantage	blt͡ʃʼ	ብልጫ
prize	blt͡ʃʼ	ብልጫ
advantage	blt͡ʃʼ	ብልጫ
virtue	blt͡ʃʼ	ብልጫ
distinction	blt͡ʃʼ	ብልጫ
trophy	blt͡ʃʼ	ብልጫ
paste	bħqʰʷ	ብሒቝ
bravo	brv	ብረቭ
gun	brt	ብረት
metal	brt	ብረት
weapon	brt	ብረት
plain	brh	ብሩህ
liquid	brh	ብሩህ
patent	brh	ብሩህ
light	brh	ብሩህ
silver	brr	ብሩር
smith	brr	ብሩር
buttermilk	brħ	ብራሕ
canteen	brʃ	ብራሾ
vellum	brn	ብራና
beaker	brkʷ	ብራኳ
height	brx	ብራኸ
elevation	brx	ብራኸ
stubble	brq	ብርቂ
prodigy	brq	ብርቂ
knee	brk	ብርኪ
knuckle	brk	ብርኪ
quota	brk	ብርኪ
stubble	brʕ	ብርዒ
stylus	brʕ	ብርዒ
pen	brʕ	ብርዒ
mole	brt	ብሮት
puncture	bsʕ	ብሳዕ
seedling	bqʷl	ብቋል
tuft	bqʷl	ብቋል
tuft	bqʰl	ብቓል
diffusion	btn	ብታነ
dissemination	btn	ብታነ
dispersion	btn	ብታነ
disintegration	btn	ብታነ
oral	bʔf	ብኣፍ
resource	bʔl	ብእሊ
corruption	bkl	ብከላ
infection	bkl	ብከላ
pollution	bkl	ብካለ
contamination	bkl	ብካለ
beaker	bxr	ብኹራ
absentee	bxr	ብኹር
waste	bxn	ብኹን
lot	bzħ	ብዙሕ
great	bzħ	ብዙሕ
peck	bzħ	ብዙሕ
pot	bzħ	ብዙሕ
quantity	bzħ	ብዙሕ
bushel	bzħ	ብዙሕ
fund	bzħ	ብዙሕ
quantum	bzħ	ብዝሒ
circulation	bzħ	ብዝሒ
wealth	bzħ	ብዝሒ
measure	bzħ	ብዝሒ
exuberance	bzħ	ብዝሒ
amount	bzħ	ብዝሒ
amplitude	bzħ	ብዝሒ
quantity	bzħ	ብዝሒ
bulk	bzħ	ብዝሒ
dish	bjt	ብያቲ
saucer	bjt	ብያቲ
immunity	bjn	ብያነ
holding	bjn	ብይን
award	bjn	ብይን
challenge	bdh	ብድሆ
initiation	bɡs	ብገሳ
incision	btʼħ	ብጣሕ
pal	bt͡ʃʼj	ብጫይ
saint	bt͡sʼʔ	ብጹእ
companion	bt͡sʼj	ብጻይ
partner	bt͡sʼj	ብጻይ
mate	bt͡sʼj	ብጻይ
fellow	bt͡sʼj	ብጻይ
buddy	bt͡sʼj	ብጻይ
pal	bt͡sʼj	ብጻይ
visitation	bt͡sʼħ	ብጽሖ
visit	bt͡sʼħ	ብጽሖ
bolt	bln	ቦሎኒ
pan	bmt͡ʃ	ቦሚቸ
bomb	bmb	ቦምባ
shrapnel	bmb	ቦምባ
bomb	bmb	ቦምብ
thrall	brj	ቦራይ
accessory	brs	ቦርሳ
bag	brs	ቦርሳ
satchel	brs	ቦርሳ
portfolio	brs	ቦርሳ
bale	bnd	ቦንዳ
video	vdj	ቪድዮ
waltz	vls	ቫልስ
vanilla	vnl	ቫኒላ
volt	vlt	ቮልት
occupant	tħz	ተሓዚ
snake	tmn	ተመን
palm	tmr	ተምሪ
fail	trf	ተረፈ
lag	trf	ተረፈ
remainder	trf	ተረፍ
residue	trf	ተረፍ
surplus	trf	ተረፍ
balance	trf	ተረፍ
vestige	trf	ተረፍ
firm	trr	ተሪር
tough	trr	ተሪር
novelist	trx	ተራኺ
sequence	trt	ተርታ
queue	trt	ተርታ
series	trt	ተርታ
index	trt	ተርታ
column	trt	ተርታ
chain	trt	ተርታ
ninety	tsʕ	ተስዓ
bubble	tsf	ተስፋ
hope	tsf	ተስፋ
promise	tsf	ተስፋ
dare	tbʕ	ተብዐ
plait	ttʕ	ተትዐ
twist	tnɡ	ተነገ
tennis	tns	ተኒስ
tent	tnd	ተንዳ
substitute	tkʔ	ተከአ
evil	tkl	ተካል
discharge	tkʷs	ተኰሰ
shoot	tkʷs	ተኰሰ
marksman	tkʷs	ተኳሲ
pitch	txl	ተኸለ
institute	txl	ተኸለ
construct	txl	ተኸለ
wolf	txl	ተኹላ
fire	txs	ተኹሲ
plant	txl	ተኽሊ
dole	txʷb	ተዀበ
poke	txʷj	ተዀየ
wolf	txʷl	ተዅላ
shot	txʷs	ተዅሲ
luxury	tdl	ተድላ
skunk	tdɡ	ተድጊ
climb	tɡr	ተገረ
grime	tɡr	ተጎሮ
enemy	tt͡sʼj	ተጻይ
opposite	tt͡sʼj	ተጻይ
vomit	tfʔ	ተፍአ
tulip	tlp	ቱሊፕ
apple	tfh	ቱፉህ
apple	tfh	ቱፋህ
apple	tfħ	ቱፋሕ
timothy	tms	ቲሞሲ
ticket	tkt	ቲከት
low	tħt	ታሕቲ
bottom	tħt	ታሕቲ
occupancy	tħz	ታሕዚ
history	trx	ታረኸ
archives	trx	ታሪኽ
history	trx	ታሪኽ
carpet	tbt	ታቦት
bugle	ttl	ታቱላ
tattoo	ttl	ታቱላ
tin	tnk	ታኒካ
can	tnk	ታኒካ
tunic	tnk	ታንክ
tank	tnk	ታንክ
turret	tnk	ታንክ
turkey	tkn	ታኪን
taxi	tks	ታክሲ
cab	tks	ታክሲ
marsh	txl	ታኼላ
slough	txl	ታኼላ
morass	txl	ታኼላ
magnate	td͡ʒr	ታጂር
tent	tnd	ቴንዳ
low	tħt	ትሑት
sub	tħt	ትሕቲ
tenure	tħz	ትሕዞ
lien	tħd͡ʒ	ትሕጃ
pledge	tħd͡ʒ	ትሕጃ
security	tħd͡ʒ	ትሕጃ
bail	tħd͡ʒ	ትሕጃ
reversion	tħd͡ʒ	ትሕጃ
pawn	tħd͡ʒ	ትሕጃ
guarantee	tħd͡ʒ	ትሕጃ
collateral	tħd͡ʒ	ትሕጃ
anecdote	trt	ትረት
absentee	trf	ትሩፍ
survival	trf	ትራ'ፍ
tram	trm	ትራም
thrush	trʃ	ትራሽ
stub	trf	ትራፍ
trolley	trl	ትሮሊ
troy	trj	ትሮይ
rope	ttʕ	ትታዕ
plait	ttʕ	ትትዖ
wit	tkr	ትኩር
alert	tkr	ትኩር
moody	tkz	ትኩዝ
patch	tkb	ትካ'ብ
plant	tkl	ትካል
establishment	tkl	ትካል
institute	tkl	ትካል
institution	tkl	ትካል
displacement	tkʔ	ትካአ
substitution	tkʔ	ትካአ
spot	tkʷʕ	ትኳዕ
fixture	txl	ትኹል
bug	txʷn	ትዃን
tweed	twd	ትዊድ
vomit	tfʔ	ትፋእ
emission	tfʔ	ትፋእ
totem	ttm	ቶትም
arson	tks	ቶኮሰ
drink	t͡ʃnt͡ʃ	ቸንቸ
bandage	t͡ʃrt	ቺረቶ
movie	t͡ʃnm	ቺነማ
cinema	t͡ʃnm	ቺነማ
hemlock	t͡ʃkt	ቺኩታ
chart	t͡ʃrt	ቻርት
urine	t͡ʃnt	ችንቲ
copper	nhs	ነሃሲ
august	nħs	ነሓሰ
fate	nsb	ነሲብ
luck	nsb	ነሲብ
rave	nqw	ነቀወ
bellow	nqw	ነቀወ
extract	nqʰl	ነቐለ
stem	nqʰl	ነቐለ
review	nqʰf	ነቐፈ
hatch	nqʰħ	ነቑሐ
point	nqʰtʼ	ነቑጣ
flaw	nqʰʕ	ነቓዕ
crevice	nqʰʕ	ነቓዕ
chink	nqʰʕ	ነቓዕ
crack	nqʰʕ	ነቓዕ
fissure	nqʰʕ	ነቓዕ
crevasse	nqʰʕ	ነቓዕ
fracture	nqʰʕ	ነቓዕ
loophole	nqʰʕ	ነቓዕ
cleavage	nqʰʕ	ነቓዕ
cranny	nqʰʕ	ነቓዕ
rift	nqʰʕ	ነቓዕ
tough	nqʰt͡sʼ	ነቓጽ
reviewer	nqʰf	ነቓፊ
fracture	nqʰʕ	ነቕዐ
drought	nqʰt͡sʼ	ነቕጺ
ex	nbr	ነበር
nebula	nbl	ነቡላ
wine	nbt	ነቢት
prophet	nbj	ነቢይ
jury	nbr	ነባሮ
audience	nbr	ነባሮ
bay	nbħ	ነብሒ
tiger	nbr	ነብሪ
leopard	nbr	ነብሪ
body	nbs	ነብሲ
burst	ntɡʷ	ነተጐ
break	ntɡʷ	ነተጐ
pop	ntɡʷ	ነተጐ
stench	ntħ	ነቲሕ
blast	ntɡʷ	ነትጒ
explosion	ntɡʷ	ነትጒ
rock	nnw	ነነወ
shake	nnw	ነነወ
no	nnʔ	ነኖእ
praise	nʔd	ነኣደ
hole	nkʷl	ነኳል
hollow	nkʷl	ነኳል
bite	nxs	ነኸሰ
affect	nxʔ	ነኽአ
leak	nxʷl	ነዃል
hole	nxʷl	ነዃል
breach	nxʷl	ነዃል
cranny	nxʷl	ነዃል
puncture	nxʷl	ነዃል
vice	nwr	ነወሪ
vise	nwr	ነወሪ
poplar	nwħ	ነዊሕ
beam	nwt	ነዊት
taboo	nwr	ነውሪ
shame	nwr	ነውሪ
upheaval	nwt͡sʼ	ነውጺ
shock	nwt͡sʼ	ነውጺ
sniff	nʕqʰ	ነዓቐ
snub	nʕqʰ	ነዓቐ
ooze	nzʕ	ነዝዐ
secretion	nzʕ	ነዝዒ
build	ndqʰ	ነደቐ
construct	ndqʰ	ነደቐ
pauper	ndj	ነደየ
design	ndf	ነደፈ
plan	ndf	ነደፈ
trace	ndf	ነደፈ
outline	ndf	ነደፈ
bile	ndd	ነዳ'ድ
gas	ndd	ነዳዲ
fuel	ndd	ነዳዲ
coupon	ndd	ነዳዲ
designer	ndf	ነዳፊ
recoil	ndħ	ነድሐ
kick	ndħ	ነድሐ
rage	ndr	ነድሪ
ire	ndr	ነድሪ
inflammation	ndr	ነድሪ
bid	nɡr	ነገረ
lawsuit	nɡr	ነገር
matter	nɡr	ነገር
thing	nɡr	ነገር
object	nɡr	ነገር
stuff	nɡr	ነገር
unit	nɡr	ነገር
material	nɡr	ነገር
tribe	nɡd	ነገድ
informant	nɡr	ነጋሪ
herald	nɡr	ነጋሪ
commerce	nɡd	ነጋዶ
furrow	nɡħ	ነግሒ
rave	nɡd	ነጎደ
thunder	nɡd	ነጎዳ
thunder	nɡʷd	ነጐደ
thunder	nɡʷd	ነጐዳ
clap	nɡʷd	ነጐዳ
pan	nɡʷd	ነጓዲ
bounce	ntʼr	ነጠረ
spring	ntʼr	ነጠረ
jump	ntʼr	ነጠረ
drip	ntʼb	ነጠበ
hopper	ntʼr	ነጣሪ
grade	ntʼb	ነጥቢ
spot	ntʼb	ነጥቢ
point	ntʼb	ነጥቢ
score	ntʼb	ነጥቢ
dot	ntʼb	ነጥቢ
period	ntʼb	ነጥቢ
aim	nt͡sʼr	ነጸ'ረ
sheet	nt͡sʼl	ነጸላ
spotlight	nt͡sʼr	ነጸረ
discard	nt͡sʼɡ	ነጸገ
discount	nt͡sʼɡ	ነጸገ
sprinkle	nt͡sʼɡ	ነጸገ
snub	nt͡sʼɡ	ነጸገ
layer	nt͡sʼf	ነጸፈ
stratum	nt͡sʼf	ነጸፈ
marksman	nt͡sʼr	ነጻሪ
repellent	nt͡sʼɡ	ነጻጊ
fly	nfr	ነፈረ
escape	nfs	ነፈሰ
blow	nfs	ነፈሰ
sieve	nfj	ነፈየ
rob	nfɡ	ነፈገ
run	nft͡sʼ	ነፈጸ
mucous	nftʼ	ነፋጥ
blare	nfħ	ነፍሐ
blow	nfħ	ነፍሐ
gun	nfħ	ነፍሒ
soul	nfs	ነፍሲ
spirit	nfs	ነፍሲ
swoop	nqʰt	ኑቕታ
avowal	nzz	ኑዛዘ
condolence	nzz	ኑዛዜ
avowal	nzz	ኑዛዜ
medal	nʃn	ኒሻን
whine	nnt	ኒንታ
nickel	nkl	ኒኬል
neon	njn	ኒዮን
hike	nhr	ናህሪ
acceleration	nhr	ናህሪ
momentum	nhr	ናህሪ
roof	nħs	ናሕሲ
Nakfa	nqʰf	ናቕፋ
foster	nbj	ናበየ
provider	nbj	ናበይ
caretaker	nbj	ናበይ
life	nbr	ናብራ
environment	nbr	ናብራ
mine	ntj	ናተይ
commendation	nʔd	ናእዳ
eulogy	nʔd	ናእዳ
praise	nʔd	ናእዳ
equipment	nwt	ናውቲ
tackle	nwt	ናውቲ
turbulence	nʕb	ናዕቢ
unrest	nʕb	ናዕቢ
trouble	nʕb	ናዕቢ
violence	nʕb	ናዕቢ
revolution	nʕb	ናዕቢ
upheaval	nʕb	ናዕቢ
pandemonium	nʕw	ናዕዋ
baby	nt͡sʼl	ናጽላ
infant	nt͡sʼl	ናጽላ
chick	nt͡sʼl	ናጽላ
babe	nt͡sʼl	ናጽላ
miss	nfqʰ	ናፈቐ
diesel	nft	ናፍታ
bee	nhb	ንህቢ
us	nħn	ንሕና
panoply	nmn	ንመን
admission	nsħ	ንስሓ
eagle	nsr	ንስሪ
excitation	nʃtʼ	ንሸጣ
cognizant	nqʰħ	ንቑሕ
stark	nqʰt͡sʼ	ንቑጽ
departure	nqʰl	ንቕሎ
reading	nbb	ንባብ
paroxysm	ntɡʷ	ንትጓ
small	nʔs	ንኡስ
junior	nʔs	ንኡስ
micro	nʔs	ንኡስ
sub	nʔs	ንኡስ
divine	nʔd	ንኡድ
oral	nʔf	ንኣፍ
bed	nʔd	ንእዲ
rebate	nkj	ንካየ
reduction	nkj	ንካይ
allowance	nkj	ንካይ
paraphernalia	nwt	ንዋት
material	nwt	ንዋት
worm	nʕqʰ	ንዑቕ
skunk	nʕqʰ	ንዑቕ
us	nʕn	ንዓና
me	nʕj	ንዓይ
download	ndt	ንዳታ
burn	ndd	ንዳድ
draft	ndf	ንድፊ
idea	ndf	ንድፊ
outline	ndf	ንድፊ
scenario	ndf	ንድፊ
design	ndf	ንድፊ
plan	ndf	ንድፊ
pattern	ndf	ንድፊ
schema	ndf	ንድፊ
model	ndf	ንድፊ
morning	nɡh	ንጉሆ
lord	nɡs	ንጉስ
territory	nɡs	ንጉስ
dictum	nɡr	ንግ'ሩ
morning	nɡh	ንግሆ
trade	nɡd	ንግዲ
commerce	nɡd	ንግዲ
business	nɡd	ንግድ
trade	nɡd	ንግድ
commerce	nɡd	ንግድ
mucus	nɡʷl	ንጓል
iota	ntʼr	ንጣር
grain	ntʼr	ንጣር
spot	ntʼb	ንጣብ
drop	ntʼb	ንጣብ
bead	ntʼb	ንጣብ
particle	ntʼr	ንጥረ
hop	ntʼr	ንጥራ
virgin	nt͡sʼh	ንጹህ
recluse	nt͡sʼl	ንጹል
liquid	nt͡sʼr	ንጹር
sharp	nt͡sʼr	ንጹር
outcast	nt͡sʼɡ	ንጹግ
anathema	nt͡sʼɡ	ንጹግ
brilliance	nt͡sʼr	ንጻር
plain	nt͡sʼr	ንጻር
emission	nt͡sʼɡ	ንጻግ
single	nt͡sʼl	ንጽል
secession	nt͡sʼl	ንጽል
wisp	nt͡sʼj	ንጽያ
spray	nt͡sʼɡ	ንጽጎ
trump	nfʕ	ንፉዕ
bulge	nfħ	ንፋሕ
wind	nfs	ንፋስ
breath	nfs	ንፋስ
mucus	nftʼ	ንፋጥ
measles	nfj	ንፍዮ
earl	ʔrl	አርል
empress	ʔtɡ	ኡቴገ
truth	ʔnt	ኡነት
veracity	ʔnt	ኡነት
reality	ʔnt	ኡነት
whiff	ʔft	ኡፍታ
flaw	ʔnt	ኢንታ
blemish	ʔnt	ኢንታ
taint	ʔnt	ኢንታ
stigma	ʔnt	ኢንታ
manual	ʔdw	ኢዳዊ
figure	ʔhz	ኣሃዝ
entity	ʔhd	ኣሃዱ
module	ʔhd	ኣሃዱ
unit	ʔhd	ኣሃዱ
item	ʔhd	ኣሃዱ
brew	ʔlm	ኣለመ
alligator	ʔlm	ኣለመ
hatch	ʔlm	ኣለመ
spin	ʔlm	ኣለመ
weave	ʔlm	ኣለመ
soak	ʔlx	ኣለኸ
drive	ʔlj	ኣለየ
shepherd	ʔlj	ኣለየ
foster	ʔlj	ኣለየ
nurse	ʔlj	ኣለየ
denial	ʔlt	ኣሉታ
negation	ʔlt	ኣሉታ
manager	ʔlj	ኣላዪ
warden	ʔlj	ኣላዪ
caretaker	ʔlj	ኣላይ
moose	ʔlt͡ʃʼ	ኣልጫ
alpha	ʔlf	ኣልፋ
custom	ʔml	ኣመል
propensity	ʔml	ኣመል
forecast	ʔmt	ኣመተ
hint	ʔmt	ኣመተ
hint	ʔmt	ኣመት
inkling	ʔmt	ኣመት
colour	ʔmt	ኣመት
wrinkle	ʔmt	ኣመት
cue	ʔmt	ኣመት
trust	ʔmn	ኣመነ
reliance	ʔmn	ኣሚን
precursor	ʔmt	ኣማቲ
confidant	ʔmn	ኣማኒ
concept	ʔmr	ኣምር
nettle	ʔmʕ	ኣምዐ
vulture	ʔmr	ኣሞራ
snail	ʔrn	ኣረነ
slug	ʔrn	ኣረነ
pick	ʔrj	ኣረየ
aria	ʔrj	ኣራዪ
heifer	ʔrħ	ኣርሒ
bull	ʔrħ	ኣርሓ
stud	ʔrħ	ኣርሓ
ensign	ʔrm	ኣርማ
symbol	ʔrm	ኣርማ
banner	ʔrm	ኣርማ
insignia	ʔrm	ኣርማ
badge	ʔrm	ኣርማ
standard	ʔrm	ኣርማ
nose	ʔsr	ኣሰ'ረ
bind	ʔsr	ኣሰረ
arrest	ʔsr	ኣሰረ
trail	ʔsr	ኣሰረ
tie	ʔsr	ኣሰረ
fix	ʔsr	ኣሰረ
pack	ʔsr	ኣሰረ
strap	ʔsr	ኣሰረ
lock	ʔsr	ኣሰረ
jail	ʔsr	ኣሰረ
track	ʔsr	ኣሰር
colour	ʔsr	ኣሰር
element	ʔsr	ኣሰር
imprint	ʔsr	ኣሰር
spice	ʔsr	ኣሰር
footprint	ʔsr	ኣሰር
impression	ʔsr	ኣሰር
evidence	ʔsr	ኣሰር
inkling	ʔsr	ኣሰር
taint	ʔsr	ኣሰር
vestige	ʔsr	ኣሰር
hook	ʔsr	ኣሰር
tracker	ʔsr	ኣሳ'ሪ
elixir	ʔst	ኣሶት
sell	ʔʃtʼ	ኣሸጠ
shelf	ʔqʰħ	ኣቕሑ
kit	ʔqʰħ	ኣቕሑ
paraphernalia	ʔqʰħ	ኣቕሓ
thing	ʔqʰħ	ኣቕሓ
appliance	ʔqʰħ	ኣቕሓ
ticket	ʔqʰħ	ኣቕሓ
unit	ʔqʰħ	ኣቕሓ
commodity	ʔqʰħ	ኣቕሓ
article	ʔqʰħ	ኣቕሓ
poise	ʔqʰm	ኣቖመ
construct	ʔqʰm	ኣቖመ
spin	ʔqʰʷm	ኣቘመ
institute	ʔqʰʷm	ኣቘመ
stipend	ʔbl	ኣበል
fault	ʔbr	ኣበር
flaw	ʔbr	ኣበር
blemish	ʔbr	ኣበር
stigma	ʔbr	ኣበር
bloom	ʔbb	ኣበባ
father	ʔbw	ኣበው
progenitor	ʔbw	ኣበው
refuse	ʔbj	ኣበየ
decline	ʔbj	ኣበየ
rebel	ʔbj	ኣበየ
pontiff	ʔbn	ኣቡን
patriarch	ʔbn	ኣቡን
bishop	ʔbn	ኣቡን
member	ʔbl	ኣባል
patrician	ʔbl	ኣባል
insider	ʔbl	ኣባል
rebel	ʔbj	ኣባዪ
booby	ʔbd	ኣብዲ
wally	ʔbd	ኣብዲ
antipathy	ʔtl	ኣተል
acrimony	ʔtl	ኣተል
otter	ʔtr	ኣተር
dip	ʔtw	ኣተወ
pierce	ʔtw	ኣተወ
reach	ʔtw	ኣተወ
income	ʔtw	ኣታዊ
revenue	ʔtw	ኣታዊ
credit	ʔtw	ኣታዊ
nucleus	ʔtm	ኣቶም
atom	ʔtm	ኣቶም
vinegar	ʔt͡ʃt	ኣቸቶ
acid	ʔt͡ʃd	ኣቺዶ
steel	ʔt͡ʃj	ኣቻዮ
barb	ʔnf	ኣንፊ
prow	ʔnf	ኣንፊ
snout	ʔnf	ኣንፊ
raise	ʔkb	ኣከበ
hoard	ʔkb	ኣከበ
aggregate	ʔkb	ኣከበ
recruit	ʔkb	ኣከበ
combination	ʔkb	ኣከበ
component	ʔkl	ኣካል
category	ʔkl	ኣካል
entity	ʔkl	ኣካል
member	ʔkl	ኣካል
person	ʔkl	ኣካል
organ	ʔkl	ኣካል
body	ʔkl	ኣካል
corpus	ʔkl	ኣካል
frame	ʔkl	ኣካል
collector	ʔkb	ኣካቢ
acre	ʔkr	ኣክር
bevy	ʔxb	ኣኼባ
assembly	ʔxb	ኣኼባ
convocation	ʔxb	ኣኼባ
conference	ʔxb	ኣኼባ
congress	ʔxb	ኣኼባ
session	ʔxb	ኣኼባ
convention	ʔxb	ኣኼባ
consultation	ʔxb	ኣኼባ
final	ʔxr	ኣኽር
last	ʔxr	ኣኽር
creditor	ʔwd	ኣዋዲ
crier	ʔwd͡ʒ	ኣዋጂ
profession	ʔwd͡ʒ	ኣዋጅ
promulgation	ʔwd͡ʒ	ኣዋጅ
emergency	ʔwd͡ʒ	ኣዋጅ
edict	ʔwd͡ʒ	ኣዋጅ
announcement	ʔwd͡ʒ	ኣዋጅ
declaration	ʔwd͡ʒ	ኣዋጅ
manifesto	ʔwd͡ʒ	ኣዋጅ
fiat	ʔwd͡ʒ	ኣዋጅ
principal	ʔwr	ኣውራ
bid	ʔzz	ኣዘዘ
command	ʔzz	ኣዘዘ
boss	ʔzz	ኣዛዚ
commander	ʔzz	ኣዛዚ
asthma	ʔzm	ኣዝማ
ear	ʔzn	ኣዝኒ
gas	ʔjr	ኣየር
atmosphere	ʔjr	ኣየር
air	ʔjr	ኣየር
springtime	ʔjt	ኣያት
flood	ʔjh	ኣይሂ
iota	ʔjt	ኣይተ
mr	ʔjt	ኣይተ
spill	ʔjd	ኣይዳ
ion	ʔjn	ኣዮን
conduct	ʔdb	ኣደብ
behaviour	ʔdb	ኣደብ
leather	ʔdɡ	ኣዳግ
mustard	ʔdr	ኣድሪ
donkey	ʔdɡ	ኣድጊ
similar to cottage	ʔd͡ʒb	ኣጁቦ
embargo	ʔɡd	ኣገ'ደ
palm	ʔɡn	ኣገን
ban	ʔɡd	ኣገደ
burke	ʔɡd	ኣገደ
shack	ʔɡd	ኣጉዶ
pedestrian	ʔɡr	ኣጋር
tureen	ʔɡr	ኣጋሮ
charity	ʔtʼm	ኣጠመ
spokesman	ʔfɲ	ኣፈኛ
elm	ʔlm	ኤልም
eden	ʔdn	ኤደን
fabric	ʔlm	እሉም
textile	ʔlm	እሉም
link	ʔlm	እላም
stitch	ʔlm	እላም
fabrication	ʔlm	እልማ
constant	ʔmn	እሙን
schedule	ʔmm	እማመ
suggestion	ʔmm	እማመ
motion	ʔmm	እማመ
overture	ʔmt	እማተ
mount	ʔmb	እምባ
mountain	ʔmb	እምባ
template	ʔmn	እምኒ
stone	ʔmn	እምኒ
lullaby	ʔrr	እሩሩ
prisoner	ʔsr	እሱር
faggot	ʔsr	እሳር
submission	ʔʃt	እሺታ
compliance	ʔʃt	እሺታ
spike	ʔʃx	እሾኽ
spine	ʔʃx	እሾኽ
shift	ʔbr	እብረ
insertion	ʔtw	እታው
importation	ʔtw	እታው
intake	ʔtw	እትዋ
income	ʔtt	እቶት
fruit	ʔtt	እቶት
revenue	ʔtt	እቶት
crop	ʔtt	እቶት
product	ʔtt	እቶት
production	ʔtt	እቶት
kiln	ʔtn	እቶን
oven	ʔtn	እቶን
woof	ʔnm	እኑም
feud	ʔnd	እንዳ
chamber	ʔnd	እንዳ
clan	ʔnd	እንዳ
yard	ʔnd	እንዳ...
artifice	ʔnd	እንዶ
vice	ʔkj	እከይ
vise	ʔkj	እከይ
evil	ʔkj	እከይ
dog	ʔkj	እከይ
batch	ʔkb	እኩብ
crop	ʔkb	እኩብ
conglomerate	ʔkb	እኩብ
collection	ʔkb	እኩብ
bunch	ʔkb	እኩብ
mass	ʔkb	እኩብ
fund	ʔkb	እኩብ
small	ʔkj	እኩይ
corpus	ʔkb	እካበ
collection	ʔkb	እካበ
salvage	ʔkb	እካብ
collection	ʔkb	እካብ
adult	ʔxl	እኹል
corn	ʔxl	እኽሊ
income	ʔxl	እኽሊ
grain	ʔxl	እኽሊ
cereal	ʔxl	እኽሊ
debt	ʔwd	እዉድ
day	ʔwn	እዋን
hour	ʔwn	እዋን
season	ʔwn	እዋን
session	ʔwn	እዋን
time	ʔwn	እዋን
era	ʔwn	እዋን
period	ʔwn	እዋን
declaration	ʔwd͡ʒ	እዋጀ
ear	ʔzn	እዝኒ
cartridge	ʔjr	እየር
portion	ʔd͡ʒm	እጃም
share	ʔd͡ʒm	እጃም
sleeve	ʔd͡ʒɡ	እጅገ
embargo	ʔɡd	እገ'ዳ
ban	ʔɡd	እገዳ
leg	ʔɡr	እግሪ
foot	ʔɡr	እግሪ
miracle	ʔt͡sʼb	እጹብ
novel	ʔt͡sʼb	እጹብ
omega	ʔmɡ	ኦመጋ
opera	ʔpr	ኦፐራ
caliph	klf	ከሊፍ
paw	klb	ከልቢ
dog	klb	ከልቢ
rob	klʔ	ከልአ
peach	kħd	ከሓደ
renegade	kħd	ከሓዲ
atheist	kħd	ከሓዲ
hip	kms	ከሙስ
comic	kmk	ከሚካ
chemistry	kmk	ከሚካ
paunch	krʃ	ከራሽ
pulp	krs	ከርሲ
myrrh	krb	ከርበ
coal	ksl	ከሰል
blame	kss	ከሰሰ
sue	kss	ከሰሰ
make	ksb	ከሰበ
gain	ksb	ከሰበ
accuser	kss	ከሳሲ
plaintiff	kss	ከሳሲ
video	kst	ከሳቲ
inspiration	kst	ከሳቲ
belly	ksʕ	ከስዐ
maw	ksʕ	ከስዐ
stomach	ksʕ	ከስዐ
fry	kʃn	ከሸነ
cook	kʃn	ከሸነ
cook	kʃn	ከሻኒ
drum	kbr	ከበሮ
highland	kbs	ከበሳ
upland	kbs	ከበሳ
investment	kbb	ከበባ
round	kbb	ከቢብ
circular	kbb	ከቢብ
area	kbb	ከባቢ
environment	kbb	ከባቢ
atmosphere	kbb	ከባቢ
locker	kbħ	ከብሒ
shelf	kbħ	ከብሒ
safe	kbħ	ከብሒ
mantel	kbħ	ከብሒ
niche	kbħ	ከብሒ
cabinet	kbħ	ከብሒ
cattle	kbt	ከብቲ
livestock	kbt	ከብቲ
belly	kbd	ከብዲ
maw	kbd	ከብዲ
stomach	kbd	ከብዲ
abdomen	kbd	ከብዲ
autograph	ktm	ከተመ
city	ktm	ከተማ
town	ktm	ከተማ
raid	ktr	ከተረ
recruit	ktb	ከተበ
definition	ktj	ከተያ
writer	ktb	ከታቢ
scribe	ktb	ከታቢ
col	ktj	ከታይ
jib	knb	ከነበ
protestant	knʃ	ከኒሻ
pill	knn	ከኒና
tablet	knn	ከኒና
hide	kwl	ከወለ
cover	kwl	ከወለ
sort	kwm	ከወመ
classification	kwm	ከወመ
lee	kwl	ከውሊ
rock	kwħ	ከውሒ
spill	kʕw	ከዓወ
warehouse	kzn	ከዘነ
cube	kjb	ከየበ
dog	kjs	ከይሲ
cover	kdn	ከደነ
roof	kdn	ከደነ
shroud	kdn	ከደነ
servant	kdm	ከዳሚ
renegade	kdʕ	ከዳዕ
pay	kfl	ከፈለ
acquit	kfl	ከፈለ
segment	kfl	ከፈለ
divide	kfl	ከፈለ
spend	kfl	ከፈለ
pioneer	kft	ከፈተ
tat	kff	ከፈፈ
aperture	kft	ከፋት
kidney	klt	ኩሊት
volume	kmr	ኩምራ
armchair	krs	ኩርሲ
chalk	krʃ	ኩርሽ
basket	krb	ኩርባ
knob	krb	ኩርባ
lip	kbj	ኩባያ
cup	kbj	ኩባያ
condition	knt	ኩነ'ተ
consideration	knt	ኩነት
form	knt	ኩነት
pickle	knt	ኩነት
stipulation	knt	ኩነት
condemnation	knn	ኩነና
damnation	knn	ኩነኔ
war	knt	ኩናት
ball	kʕs	ኩዕሶ
tor	kd͡ʒt	ኩጀት
math	kt͡sʼr	ኩጽሪ
tiara	kft	ኩፍታ
cupid	kpd	ኩፒዶ
coupon	kpn	ኩፖን
practitioner	kʔl	ኪኢላ
parole	kdn	ኪዳን
testament	kdn	ኪዳን
confederation	kdn	ኪዳን
alliance	kdn	ኪዳን
pact	kdn	ኪዳን
priest	khn	ካህን
pastor	khn	ካህን
sock	kls	ካልሲ
other	klʔ	ካልእ
second	klʔ	ካልእ
restitution	kħs	ካሕሳ
compensation	kħs	ካሕሳ
video	kmr	ካመራ
camera	kmr	ካመራ
shirt	kmʃ	ካሚሻ
blouse	kmʃ	ካሚሻ
camp	kmb	ካምቦ
shirt	kmt͡ʃ	ካምቻ
blouse	kmt͡ʃ	ካምቻ
cameo	kmj	ካምዮ
caribou	krb	ካሪቡ
karma	krm	ካርማ
card	krt	ካርታ
plan	krt	ካርታ
map	krt	ካርታ
carp	krp	ካርፕ
cab	krs	ካሮሳ
trap	krs	ካሮሳ
carrot	krt	ካሮቲ
carrot	krt	ካሮት
teller	ksr	ካሴር
crate	kst	ካሴታ
cashmere	kʃw	ካሺው
us	kbn	ካቢነ
cabin	kbn	ካቢነ
cabinet	kbn	ካቢነ
cabaret	kbr	ካባረ
ulster	kbt	ካቦት
marking	ktm	ካቲም
motif	ktm	ካቲም
canary	knr	ካናሪ
cocoa	kkw	ካካው
savoy	kwl	ካውሎ
magazine	kzn	ካዝና
china	kjl	ካይላ
pottery	kjl	ካይላ
porcelain	kjl	ካይላ
cadet	kdt	ካደት
drizzle	kfj	ካፈየ
shower	kfj	ካፈየ
club	klb	ክለብ
wit	klm	ክሊማ
climate	klm	ክሊማ
clam	klm	ክላም
pooh	klʔ	ክላእ!
reservation	kll	ክልል
pair	klt	ክልተ
jack	krk	ክሪክ
obesity	krʃ	ክራሸ
chunk	krt	ክራት
hire	krj	ክራይ
lease	krj	ክራይ
royalty	krj	ክራይ
charter	krj	ክራይ
hickory	krj	ክርያ
chrome	krm	ክሮም
croquet	krk	ክሮክ
respondent	kss	ክሱስ
toll	ksr	ክሳራ
till	ksb	ክሳብ
notch	ksd	ክሳድ
neck	ksd	ክሳድ
isthmus	ksd	ክሳድ
kitchen	kʃn	ክሽነ
cuisine	kʃn	ክሽነ
union	kbb	ክበብ
orb	kbb	ክበብ
gold	kbr	ክቡር
gem	kbr	ክቡር
august	kbr	ክቡር
dear	kbr	ክቡር
tuck	kbs	ክባስ
seam	kbs	ክባስ
appreciation	kbr	ክብሪ
value	kbr	ክብሪ
merit	kbr	ክብሪ
worth	kbr	ክብሪ
amount	kbr	ክብሪ
reputation	kbr	ክብሪ
pride	kbr	ክብሪ
elevation	kbr	ክብሪ
price	kbr	ክብሪ
elevation	kbt	ክብታ
recruit	ktb	ክታ'ብ
signature	ktm	ክታም
talisman	ktb	ክታብ
amulet	ktb	ክታብ
raid	ktr	ክትራ
obstruction	ktr	ክትራ
discussion	ktʕ	ክትዐ
discussion	ktʕ	ክትዕ
debate	ktʕ	ክትዕ
argument	ktʕ	ክትዕ
controversy	ktʕ	ክትዕ
supra	knj	ክንዮ-
equivalent	knd	ክንዲ
wing	knf	ክንፊ
fin	knf	ክንፊ
artisan	kʔl	ክኢላ
consultant	kʔl	ክኢላ
virtuoso	kʔl	ክኢላ
expert	kʔl	ክኢላ
specialist	kʔl	ክኢላ
professional	kʔl	ክኢላ
practitioner	kʔl	ክኢላ
fact	kwn	ክውን
placement	kwn	ክውን
store	kzn	ክዙን
apparel	kdn	ክዳን
template	kdn	ክዳን
dress	kdn	ክዳን
detail	kfl	ክፋል
component	kfl	ክፋል
segment	kfl	ክፋል
quantum	kfl	ክፋል
section	kfl	ክፋል
part	kfl	ክፋል
fraction	kfl	ክፋል
proportion	kfl	ክፋል
portion	kfl	ክፋል
opening	kft	ክፋት
class	kfl	ክፍሊ
grade	kfl	ክፍሊ
category	kfl	ክፍሊ
chamber	kfl	ክፍሊ
theatre	kfl	ክፍሊ
room	kfl	ክፍሊ
department	kfl	ክፍሊ
cell	kfl	ክፍሊ
scout	kll	ኮለለ
college	kld͡ʒ	ኮለጅ
scout	kll	ኮላሊ
colon	kln	ኮሎን
convoy	klɲ	ኮሎኛ
heather	klɲ	ኮሎኛ
aggregate	kmr	ኮመረ
bundle	kmr	ኮመረ
comet	kmt	ኮመት
committee	kmt	ኮመት
comedy	kmd	ኮመዲ
committee	kmt	ኮሚተ
quarter	krm	ኮረማ
castor	krr	ኮረር
effigy	krr	ኮረር
metal	krt	ኮረት
course	krs	ኮርስ
cobra	kbr	ኮብራ
drum	kbr	ኮቦሮ
insert	ktt	ኮተቴ
colt	ktt	ኮቴት
buck	knʕ	ኮናዕ
cognac	kɲk	ኮኛክ
star	kxb	ኮኸብ
star	kxb	ኮኾብ
coyote	kjt	ኮዮት
kodak	kdk	ኮዳክ
skirt	kʷll	ኰለለ
demarcation	kʷll	ኰለሎ
polish	kʷlʕ	ኰልዐ
fuck	kʷrd	ኰረደ
colt	kʷtt	ኰተቴ
stag	kʷnʕ	ኰናዕ
hart	kʷnʕ	ኰናዕ
dig	kʷʕt	ኰዓተ
burrow	kʷʕt	ኰዓተ
digger	kʷʕt	ኰዓቲ
doom	kʷnn	ኲነነ
arrow	kʷnt	ኲናት
war	kʷnt	ኲናት
collar	kʷlt	ኳሌታ
spindle	kʷlb	ኳልባ
bang	kʷħt	ኳሕታ
crack	kʷħt	ኳሕታ
rap	kʷħt	ኳሕታ
cart	kʷrt	ኳርት
bandit	kʷtr	ኳትራ
levee	kʷtr	ኳትራ
weir	kʷtr	ኳትራ
grub	kʷʕt	ኳዓተ
kidney	kʷlt	ኵሊት
mouthful	kʷls	ኵላሶ
mass	kʷmr	ኵምራ
camera	kʷmr	ኵምራ
grand	kʷrʕ	ኵሩዕ
hill	kʷrb	ኵርባ
excrement	kʷsħ	ኵስሒ
essence	kʷnt	ኵነት
future	kʷnt	ኵነት
situation	kʷnt	ኵነት
incident	kʷnt	ኵነት
paradox	kʷnt	ኵነት
denunciation	kʷnn	ኵነና
pike	kʷnt	ኵናት
tor	kʷd͡ʒt	ኵጀት
giver	whb	ወሃቢ
donor	whb	ወሃቢ
contributor	whb	ወሃቢ
produce	wld	ወለደ
breed	wld	ወለደ
relative	wld	ወለዲ
parent	wld	ወለዲ
interest	wld	ወለድ
extraction	wld	ወለዶ
genealogy	wld	ወለዶ
generation	wld	ወለዶ
lighter	wld	ወላዲ
parent	wld	ወላዲ
maternity	wld	ወላድ
flash	wlʕ	ወልዐ
addiction	wlf	ወልፊ
virtuoso	wħl	ወሓለ
expert	wħl	ወሓለ
artist	wħl	ወሓለ
specialist	wħl	ወሓለ
snow	wħz	ወሓዘ
stream	wħz	ወሓዘ
flow	wħz	ወሓዘ
creek	wħz	ወሓዚ
decline	wħd	ወሓደ
decrease	wħd	ወሓደ
gulp	wħtʼ	ወሓጠ
incursion	wrr	ወረረ
invasion	wrr	ወረረ
onset	wrr	ወረረ
levy	wrs	ወረሰ
borough	wrd	ወረደ
fall	wrd	ወረደ
part	wrd	ወረዳ
ward	wrd	ወረዳ
district	wrd	ወረዳ
township	wrd	ወረዳ
noble	wrd͡ʒ	ወረጃ
lady	wrd͡ʒ	ወረጃ
gentleman	wrd͡ʒ	ወረጃ
politic	wrd͡ʒ	ወረጃ
quiet	wrd͡ʒ	ወረጃ
forceps	wrtʼ	ወረጦ
invader	wrr	ወራሪ
incursion	wrr	ወራር
invasion	wrr	ወራር
reward	wrt	ወሬታ
month	wrħ	ወርሒ
moon	wrħ	ወርሒ
gold	wrq	ወርቂ
lady	wrz	ወርዞ
sex	wsb	ወሰበ
judge	wsn	ወሰነ
resolve	wsn	ወሰነ
bank	wsn	ወሰን
limit	wsn	ወሰን
frontier	wsn	ወሰን
border	wsn	ወሰን
wall	wsn	ወሰን
increase	wsx	ወሰኸ
annex	wsx	ወሰኸ
supplement	wsx	ወሰኸ
addition	wsx	ወሰኽ
appendix	wsx	ወሰኽ
appreciation	wsx	ወሰኽ
augmentation	wsx	ወሰኽ
extension	wsx	ወሰኽ
growth	wsx	ወሰኽ
increase	wsx	ወሰኽ
take	wsd	ወሰደ
executive	wsn	ወሳኒ
arbiter	wsn	ወሳኒ
gesture	wst	ወስታ
wedge	wʃl	ወሸለ
tattoo	wqtʼ	ወቀ'ጠ
imprint	wqtʼ	ወቀጠ
blame	wqʰs	ወቐሰ
slur	wqʰs	ወቐሳ
pestle	wqʰtʼ	ወቐጠ
knocker	wqʰʕ	ወቓዒ
reproach	wqʰs	ወቕሳ
term	wqʰt	ወቕቲ
pelt	wqʰʕ	ወቕዐ
drum	wqʰʕ	ወቕዐ
pulse	wqʰʕ	ወቕዐ
hit	wqʰʕ	ወቕዐ
beat	wqʰʕ	ወቕዐ
nape	wtɡ	ወተግ
insert	wtf	ወተፈ
owner	wnn	ወናኒ
delegation	wkl	ወከለ
delegate	wkl	ወከለ
advocate	wkl	ወከል
accusation	wks	ወከሰ
giggle	wkx	ወከኸ
deputy	wkl	ወኪል
proxy	wkl	ወኪል
delegate	wkl	ወኪል
commissioner	wkl	ወኪል
representative	wkl	ወኪል
factor	wkl	ወኪል
agent	wkl	ወኪል
emissary	wkl	ወኪል
barrier	wkl	ወኪል
advocator	wkl	ወካሊ
accuser	wks	ወካሲ
monkey	wʕɡ	ወዓግ
pyramid	wzt	ወዘተ
president	wzt	ወዘተ
cascade	wzt	ወዘተ
serial	wzt	ወዘተ
epic	wzt	ወዘተ
multiple	wzt	ወዘተ
skein	wzt	ወዘተ
slut	wzl	ወዛል
jade	wzm	ወዛም
accident	wzb	ወዝቢ
chance	wzb	ወዝቢ
contingency	wzb	ወዝቢ
dive	wjn	ወየነ
hepatitis	wjb	ወይቦ
buff	wjb	ወይቦ
grape	wjn	ወይኒ
renegade	wjtʼ	ወይጦ
jackass	wdl	ወደል
soap	wds	ወደሰ
spill	wdqʰ	ወደቐ
founder	wdqʰ	ወደቐ
collapse	wdqʰ	ወደቐ
fall	wdqʰ	ወደቐ
port	wdb	ወደብ
executor	wdʔ	ወዳኢ
consumer	wdʔ	ወዳኢ
exhaust	wdʔ	ወድአ
cost	wdʔ	ወድአ
finish	wdʔ	ወድአ
slut	wd͡ʒb	ወጃብ
face	wd͡ʒh	ወጅሂ
dimension	wɡn	ወገን
party	wɡn	ወገን
side	wɡn	ወገን
taboo	wɡz	ወገዘ
portico	wɡf	ወገፈ
vestibule	wɡf	ወገፈ
acid	wɡʔ	ወጋኢ
dawn	wɡħ	ወግሐ
abortion	wɡr	ወግሪ
stab	wɡʔ	ወግአ
pierce	wɡʔ	ወግአ
gore	wɡʔ	ወግአ
prick	wɡʔ	ወግአ
chat	wɡʕ	ወግዒ
protocol	wɡʕ	ወግዒ
decorum	wɡʕ	ወግዒ
formality	wɡʕ	ወግዒ
ceremony	wɡʕ	ወግዒ
surgeon	wɡʷs	ወጔሳ
quiz	wtʼr	ወጠረ
purpose	wtʼn	ወጠነ
tug	wtʼtʼ	ወጠጠ
goat	wtʼtʼ	ወጠጦ
interloper	wtʼm	ወጣም
intruder	wtʼm	ወጣም
yelp	wt͡ʃʼt͡ʃʼ	ወጨጨ
squeal	wt͡ʃʼt͡ʃʼ	ወጨጨ
screech	wt͡ʃʼt͡ʃʼ	ወጨጨ
cry	wt͡ʃʼt͡ʃʼ	ወጨጨ
anvil	wt͡sʼqʰ	ወጸቓ
expenditure	wt͡sʼʔ	ወጻኢ
outlay	wt͡sʼʔ	ወጻኢ
outside	wt͡sʼʔ	ወጻኢ
exterior	wt͡sʼʔ	ወጻኢ
expense	wt͡sʼʔ	ወጻኢ
detriment	wt͡sʼʕ	ወጽዓ
injury	wt͡sʼʕ	ወጽዓ
offering	wfj	ወፈ'የ
mortgage	wfj	ወፈየ
donation	wfj	ወፈያ
dedication	wfj	ወፈያ
kitty	wfj	ወፈያ
consecration	wfj	ወፈያ
subscription	wfj	ወፈያ
endowment	wfj	ወፈያ
offer	wfj	ወፈያ
contributor	wfj	ወፋይ
investment	wfr	ወፍሪ
campaign	wfr	ወፍሪ
grape	wjn	ዉያነ
willow	wlw	ዊለው
willow	wlw	ዊሎው
volition	wnt	ዊንታ
predilection	wnt	ዊንታ
cell	whj	ዋህዮ
while	wlkʷ	ዋላ'ኳ
shield	wlt	ዋልታ
virtuoso	wħl	ዋሓለ
drainage	wħz	ዋሓዚ
warrant	wħs	ዋሕስ
bail	wħs	ዋሕስ
guarantee	wħs	ዋሕስ
effusion	wħz	ዋሕዚ
influx	wħz	ዋሕዚ
exodus	wħz	ዋሕዚ
flux	wħz	ዋሕዚ
tide	wħz	ዋሕዚ
shortage	wħd	ዋሕዲ
want	wħd	ዋሕዲ
lack	wħd	ዋሕዲ
paucity	wħd	ዋሕዲ
deficit	wħd	ዋሕዲ
dearth	wħd	ዋሕዲ
merger	wħtʼ	ዋሕጢ
business	wnn	ዋኒን
preoccupation	wnn	ዋኒን
biz	wnn	ዋኒን
enterprise	wnn	ዋኒን
agency	wnn	ዋኒን
goblet	wnt͡ʃʼ	ዋንጫ
mug	wnt͡ʃʼ	ዋንጫ
cup	wnt͡ʃʼ	ዋንጫ
council	wʕl	ዋዕላ
conference	wʕl	ዋዕላ
convention	wʕl	ዋዕላ
bitch	wʕr	ዋዕሮ
loudness	wʕt	ዋዕታ
vigil	wzm	ዋዜማ
eve	wzm	ዋዜማ
compound	whd	ውሁድ
ensemble	whd	ውህዶ
chord	whd	ውህዶ
son	wld	ውሉድ
progeny	wld	ውሉድ
scion	wld	ውሉድ
progeny	wld	ውላድ
daughter	wld	ውላድ
auto	wlq	ውልቀ
crumb	wħd	ውሑድ
little	wħd	ውሑድ
current	wħd͡ʒ	ውሑጅ
glutton	wħtʼ	ውሒጣ
professional	wħl	ውሓለ
pro	wħl	ውሓለ
race	wħd͡ʒ	ውሕጅ
classic	wrj	ውሩይ
star	wrj	ውሩይ
gala	wrj	ውራይ
conscription	wrs	ውርሲ
confiscation	wrs	ውርሳ
legacy	wrʃ	ውርሻ
heirloom	wrʃ	ውርሻ
heritage	wrʃ	ውርሻ
width	wrd	ውርዲ
snow	wrt͡ʃʼ	ውርጪ
finding	wsn	ውሳነ
decision	wsn	ውሳኔ
determination	wsn	ውሳኔ
deep	wʃtʼ	ውሹጥ
wedge	wʃl	ውሻል
ben	wʃtʼ	ውሻጠ
pantry	wʃtʼ	ውሻጠ
lover	wʃm	ውሽማ
depth	wʃtʼ	ውሽጢ
inside	wʃtʼ	ውሽጢ
tattoo	wqtʼ	ውቃ'ጦ
grace	wqb	ውቃበ
expression	wqb	ውቃበ
glory	wbt	ውበት
charm	wbt	ውበት
glamour	wbt	ውበት
property	wnn	ውነና
ownership	wnn	ውነና
offering	wkf	ውከፋ
input	wkf	ውከፋ
giggle	wkx	ውካኸ
elk	wʕl	ውዕላ
treaty	wʕl	ውዕል
compact	wʕl	ውዕል
pledge	wʕl	ውዕል
agreement	wʕl	ውዕል
deal	wʕl	ውዕል
bond	wʕl	ውዕል
pact	wʕl	ውዕል
contract	wʕl	ውዕል
engagement	wʕl	ውዕል
convention	wʕl	ውዕል
quandary	wʕl	ውዕል
fiasco	wdqʰ	ውዱቕ
object	wdʕ	ውዱዕ
conspiracy	wdt	ውዲት
ruse	wdt	ውዲት
plot	wdt	ውዲት
scheme	wdt	ውዲት
cabal	wdt	ውዲት
collusion	wdt	ውዲት
glory	wds	ውዳሰ
eulogy	wds	ውዳሰ
ode	wds	ውዳሰ
organization	wdb	ውድብ
equilibrium	wdn	ውድን
damnation	wɡz	ውገዛ
excommunication	wɡz	ውገዛ
exclusion	wɡd	ውገዳ
injection	wɡʔ	ውጋአ
attack	wɡʔ	ውግኣ
battle	wɡʔ	ውግእ
fight	wɡʔ	ውግእ
schedule	wtʼn	ውጥን
agenda	wtʼn	ውጥን
itinerary	wtʼn	ውጥን
scheme	wtʼn	ውጥን
proposal	wtʼn	ውጥን
plan	wtʼn	ውጥን
strategy	wtʼn	ውጥን
intent	wtʼn	ውጥን
project	wtʼn	ውጥን
squeal	wt͡ʃʼt͡ʃʼ	ውጫጨ
ill	wt͡sʼʕ	ውጹዕ
splinter	wt͡sʼl	ውጻል
militant	wfj	ውፉይ
lobby	wfr	ውፍራ
swoon	ʕlt	ዑለት
refugee	ʕqʰb	ዑቑብ
shelter	ʕqʰb	ዑቕባ
tour	ʕdt	ዑደት
race	ʕdt	ዑደት
revolution	ʕdt	ዑደት
circuit	ʕdt	ዑደት
orbit	ʕdt	ዑደት
cycle	ʕdt	ዑደት
corn	ʕfn	ዑፉን
maize	ʕfn	ዑፉን
butt	ʕlm	ዒላማ
target	ʕlm	ዒላማ
sitter	ʕlm	ዒላማ
kitten	ʕwl	ዒዋል
family	ʕwl	ዒዋል
breed	ʕlm	ዓለ'መ
earth	ʕlm	ዓለም
world	ʕlm	ዓለም
layman	ʕlm	ዓለም
globe	ʕlm	ዓለም
land	ʕlb	ዓለበ
rest	ʕlb	ዓለበ
sit	ʕlb	ዓለበ
tissue	ʕlb	ዓለባ
fabric	ʕlb	ዓለባ
web	ʕlb	ዓለባ
textile	ʕlb	ዓለባ
cloth	ʕlb	ዓለባ
rebel	ʕlw	ዓለወ
trainer	ʕlm	ዓላሚ
instructor	ʕlm	ዓላሚ
commentator	ʕlqʰ	ዓላቒ
rebel	ʕlw	ዓላዊ
heredity	ʕlt	ዓሌት
feud	ʕlt	ዓሌት
kind	ʕlt	ዓሌት
blindfold	ʕmt	ዓመተ
year	ʕmt	ዓመት
abuse	ʕmt͡sʼ	ዓመጸ
rape	ʕmt͡sʼ	ዓመጸ
encroachment	ʕmt͡sʼ	ዓመጽ
felony	ʕmt͡sʼ	ዓመጽ
aggression	ʕmt͡sʼ	ዓመጽ
violence	ʕmt͡sʼ	ዓመጽ
customer	ʕml	ዓሚል
client	ʕml	ዓሚል
deep	ʕmqʰʷ	ዓሚቚ
crook	ʕmt͡sʼ	ዓማጺ
column	ʕmd	ዓምዲ
bullet	ʕrr	ዓረር
lead	ʕrr	ዓረር
ball	ʕrr	ዓረር
shot	ʕrr	ዓረር
die	ʕrf	ዓረፈ
bed	ʕrt	ዓራት
peacemaker	ʕrj	ዓራዪ
moderator	ʕrj	ዓራዪ
arbitrator	ʕrj	ዓራዪ
friday	ʕrb	ዓርቢ
friend	ʕrk	ዓርኪ
partner	ʕrk	ዓርኪ
fellow	ʕrk	ዓርኪ
buddy	ʕrk	ዓርኪ
pal	ʕrk	ዓርኪ
company	ʕrk	ዓርኪ
juice	ʕsr	ዓሲር
pay	ʕsb	ዓስቢ
stipend	ʕsb	ዓስቢ
seal	ʕʃɡ	ዓሸገ
coop	ʕʃɡ	ዓሸገ
preserve	ʕqb	ዓቀበ
treasure	ʕqb	ዓቀበ
dose	ʕqn	ዓቀነ
gauge	ʕqn	ዓቀነ
preservative	ʕqb	ዓቃቢ
save	ʕqʰb	ዓቐበ
slope	ʕqʰb	ዓቐብ
dimension	ʕqʰn	ዓቐን
measure	ʕqʰn	ዓቐን
dosage	ʕqʰn	ዓቐን
size	ʕqʰn	ዓቐን
quantity	ʕqʰn	ዓቐን
dose	ʕqʰn	ዓቐን
equanimity	ʕqʰl	ዓቕሊ
sobriety	ʕqʰl	ዓቕሊ
capacity	ʕqʰm	ዓቕሚ
power	ʕqʰm	ዓቕሚ
ability	ʕqʰm	ዓቕሚ
capability	ʕqʰm	ዓቕሚ
strength	ʕqʰm	ዓቕሚ
scope	ʕqʰm	ዓቕሚ
hoard	ʕqʰr	ዓቖረ
save	ʕqʰʷr	ዓቘረ
stop	ʕbs	ዓበሰ
throttle	ʕbs	ዓበሰ
burke	ʕbs	ዓበሰ
scab	ʕbqʰ	ዓበቕ
mushroom	ʕbj	ዓበየ
dummy	ʕbs	ዓባስ
grandma	ʕbj	ዓባይ
granny	ʕbj	ዓባይ
chickpea	ʕtr	ዓተር
collapse	ʕnw	ዓነወ
column	ʕnd	ዓንዲ
peasant	ʕkʷj	ዓኳይ
farmer	ʕkʷj	ዓኳይ
phlegm	ʕxt	ዓኽታ
ochre	ʕxʷr	ዓዀር
swain	ʕxʷj	ዓዃይ
victory	ʕwt	ዓወት
battle	ʕwt	ዓወት
fortune	ʕwt	ዓወት
win	ʕwt	ዓወት
success	ʕwt	ዓወት
luck	ʕwt	ዓወት
triumph	ʕwt	ዓወት
achievement	ʕwt	ዓወት
muddle	ʕwn	ዓወነ
fool	ʕwn	ዓዋን
jackass	ʕwn	ዓዋን
loudness	ʕwt	ዓውታ
arena	ʕwd	ዓውዲ
scope	ʕwd	ዓውዲ
sphere	ʕwd	ዓውዲ
field	ʕwd	ዓውዲ
realm	ʕwd	ዓውዲ
eye	ʕjn	ዓይኒ
orb	ʕjn	ዓይኒ
fatherland	ʕdb	ዓደቦ
homeland	ʕdb	ዓደቦ
trespass	ʕdw	ዓደወ
buy	ʕdɡ	ዓደገ
miner	ʕdn	ዓዳኒ
debtor	ʕdj	ዓዳዪ
buyer	ʕdɡ	ዓዳጊ
convoy	ʕd͡ʒb	ዓጀበ
escort	ʕd͡ʒb	ዓጀበ
courtier	ʕd͡ʒb	ዓጃቢ
injury	ʕɡb	ዓገብ
stop	ʕɡt	ዓገተ
gulp	ʕɡt	ዓገተ
jam	ʕɡt	ዓገተ
tie	ʕɡt	ዓገተ
ban	ʕɡt	ዓገተ
tackle	ʕɡt	ዓገተ
check	ʕɡt	ዓገተ
barricade	ʕɡt	ዓገተ
wrinkle	ʕtʼr	ዓጠረ
seal	ʕt͡sʼw	ዓጸወ
fence	ʕt͡sʼw	ዓጸወ
latch	ʕt͡sʼw	ዓጸወ
padlock	ʕt͡sʼw	ዓጸወ
button	ʕt͡sʼw	ዓጸወ
scythe	ʕt͡sʼd	ዓጸደ
crease	ʕt͡sʼf	ዓጸፈ
flex	ʕt͡sʼf	ዓጸፈ
fold	ʕt͡sʼf	ዓጸፈ
bend	ʕt͡sʼf	ዓጸፈ
tough	ʕt͡sʼqʰ	ዓጺቕ
reaper	ʕt͡sʼd	ዓጻዲ
bone	ʕt͡sʼm	ዓጽሚ
knuckle	ʕt͡sʼq	ዓጽቂ
bubble	ʕfr	ዓፈረ
froth	ʕfr	ዓፈረ
foam	ʕfr	ዓፈረ
burke	ʕfn	ዓፈነ
bubble	ʕfr	ዓፍራ
froth	ʕfr	ዓፍራ
scum	ʕfr	ዓፍራ
foam	ʕfr	ዓፍራ
challenge	ʕmħ	ዔማሕ
day	ʕlt	ዕለት
date	ʕlt	ዕለት
tale	ʕll	ዕላል
gossip	ʕll	ዕላል
chat	ʕll	ዕላል
goal	ʕlm	ዕላማ
intention	ʕlm	ዕላማ
aim	ʕlm	ዕላማ
design	ʕlm	ዕላማ
mecca	ʕlm	ዕላማ
objective	ʕlm	ዕላማ
target	ʕlm	ዕላማ
banner	ʕlm	ዕላማ
view	ʕlm	ዕላማ
purpose	ʕlm	ዕላማ
intent	ʕlm	ዕላማ
agenda	ʕlm	ዕላማ
tuition	ʕlm	ዕላማ
grass	ʕlm	ዕላም
coup	ʕlw	ዕልዋ
cluster	ʕmr	ዕሙር
pursuit	ʕmm	ዕማም
assignment	ʕmm	ዕማም
labor	ʕmm	ዕማም
job	ʕmm	ዕማም
function	ʕmm	ዕማም
role	ʕmm	ዕማም
business	ʕmm	ዕማም
enterprise	ʕmm	ዕማም
task	ʕmm	ዕማም
affair	ʕmm	ዕማም
duration	ʕmr	ዕምሪ
fist	ʕmk	ዕምኮ
punch	ʕmk	ዕምኮ
fist	ʕmkʷ	ዕምኰ
thread	ʕrd	ዕራድ
arbitration	ʕrq	ዕርቂ
bulwark	ʕrd	ዕርዲ
fort	ʕrd	ዕርዲ
bastion	ʕrd	ዕርዲ
stronghold	ʕrd	ዕርዲ
mercenary	ʕsb	ዕሱብ
army	ʕsl	ዕስለ
cluster	ʕsl	ዕስለ
bevy	ʕsl	ዕስለ
colony	ʕsl	ዕስለ
horde	ʕsl	ዕስለ
gang	ʕsl	ዕስለ
infant	ʕʃl	ዕሸል
quantity	ʕqn	ዕቀና
preservation	ʕqb	ዕቁብ
preservation	ʕqb	ዕቃበ
conservation	ʕqb	ዕቃበ
maintenance	ʕqb	ዕቃበ
dimension	ʕqn	ዕቅን
pool	ʕqʷr	ዕቋር
hoard	ʕqʰr	ዕቑር
favourite	ʕqʰb	ዕቑብ
bastion	ʕqʰʷb	ዕቝባ
snob	ʕbj	ዕቡይ
lunatic	ʕbd	ዕቡድ
maniac	ʕbd	ዕቡድ
growth	ʕbt	ዕቤት
magnitude	ʕbt	ዕቤት
grave	ʕtb	ዕቱብ
tuft	ʕtr	ዕታሮ
urn	ʕtr	ዕትሮ
pot	ʕtr	ዕትሮ
static	ʕnd	ዕኑድ
bead	ʕnq	ዕንቆ
bead	ʕnqʷ	ዕንቊ
stone	ʕnqʷ	ዕንቊ
pearl	ʕnqʷ	ዕንቍ
demolition	ʕnw	ዕንዋ
chick	ʕnd	ዕንዱ
wasp	ʕkt	ዕኮት
blind	ʕwr	ዕዉር
winner	ʕwt	ዕዉት
victor	ʕwt	ዕውት
probation	ʕzb	ዕዘባ
august	ʕzz	ዕዙዝ
affluence	ʕzz	ዕዛዘ
exuberance	ʕzz	ዕዛዘ
lamb	ʕjt	ዕየት
stagnation	ʕjɡ	ዕያገ
puddle	ʕjɡ	ዕያግ
pond	ʕjɡ	ዕያግ
distribution	ʕdl	ዕደላ
bombast	ʕdxʷ	ዕደዃ
guest	ʕdm	ዕዲም
market	ʕdɡ	ዕዳጋ
chance	ʕdl	ዕድል
scope	ʕdl	ዕድል
luck	ʕdl	ዕድል
price	ʕdl	ዕድል
room	ʕdl	ዕድል
opportunity	ʕdl	ዕድል
probability	ʕdl	ዕድል
age	ʕdm	ዕድመ
standing	ʕdm	ዕድመ
duration	ʕdm	ዕድመ
convoy	ʕd͡ʒb	ዕጀባ
content	ʕɡb	ዕጉብ
prevention	ʕɡt	ዕግታ
blockade	ʕɡt	ዕግታ
obstruction	ʕɡt	ዕግታ
crease	ʕtʼr	ዕጣር
seam	ʕtʼr	ዕጣር
wrinkle	ʕtʼr	ዕጣሮ
truss	ʕtʼqʰ	ዕጣቕ
frankincense	ʕtʼn	ዕጣን
weapon	ʕtʼq	ዕጥቂ
crease	ʕt͡sʼf	ዕጻፍ
tuck	ʕt͡sʼf	ዕጻፍ
fold	ʕt͡sʼf	ዕጻፍ
wrinkle	ʕt͡sʼf	ዕጻፍ
closure	ʕt͡sʼw	ዕጽዋ
double	ʕt͡sʼf	ዕጽፊ
maize	ʕfn	ዕፉን
jump	zll	ዘለለ
bunch	zll	ዘለላ
slang	zlf	ዘለፈ
attack	zlf	ዘለፈ
affront	zlf	ዘለፈ
affront	zlf	ዘለፋ
despot	zlm	ዘላሚ
ease	zħl	ዘሓለ
lag	zħtʼ	ዘሓጠ
carol	zmr	ዘመረ
harry	zmt	ዘመተ
crusade	zmt	ዘመተ
campaign	zmt	ዘመተ
age	zmn	ዘመን
century	zmn	ዘመን
era	zmn	ዘመን
period	zmn	ዘመን
relative	zmd	ዘመድ
relation	zmd	ዘመድ
talk	zrb	ዘረባ
conversation	zrb	ዘረባ
language	zrb	ዘረባ
speech	zrb	ዘረባ
puddle	zrɡ	ዘረገ
muddle	zrɡ	ዘረገ
mess	zrɡ	ዘረገ
kidnap	zrf	ዘረፈ
loot	zrf	ዘረፋ
prodigal	zrw	ዘራዊ
giraffe	zrf	ዘራፍ
section	zrf	ዘራፍ
seed	zrʔ	ዘርአ
blood	zrʔ	ዘርኢ
birth	zrʔ	ዘርኢ
seed	zrʔ	ዘርኢ
extraction	zrʔ	ዘርኢ
progeny	zrʔ	ዘርኢ
broadcast	zrʔ	ዘርኤ
slant	zbl	ዘበለ
land	zbtʼ	ዘበጠ
club	zbtʼ	ዘበጠ
slug	zbtʼ	ዘበጠ
currant	zbb	ዘቢብ
talk	ztj	ዘተየ
rain	znb	ዘነበ
axis	znɡ	ዘንጊ
shank	znɡ	ዘንጊ
shaft	znɡ	ዘንጊ
recall	zkr	ዘከረ
visit	zwr	ዘወረ
crank	zwr	ዘወረ
tourist	zwr	ዘዋሪ
driver	zwr	ዘዋሪ
circular	zwr	ዘዋሪ
diffusion	zwħ	ዘውሒ
tiara	zwd	ዘውዲ
tilt	zzw	ዘዘወ
absentee	zjl	ዘየሎ
oil	zjt	ዘየተ
oil	zjt	ዘይቲ
requirement	zdl	ዘድሊ
sediment	zft	ዘፍታ
rpm	zʔd	ዙ.ኣ.ደ
rotation	zrt	ዙረት
picnic	zrt	ዙረት
tour	zrt	ዙረት
circulation	zrt	ዙረት
hike	zrt	ዙረት
jaunt	zrt	ዙረት
walk	zrt	ዙረት
tourism	zrt	ዙረት
cycle	zrt	ዙረት
circuit	zrj	ዙርያ
circle	zrj	ዙርያ
zucchini	zkn	ዙኪኒ
ideal	zqd	ዚቃዶ
forerunner	znj	ዚንያ
bone	zhr	ዛህር
abstinence	zhd	ዛህዲ
cold	zħl	ዛሕሊ
yard	zrb	ዛሬባ
atrium	zrb	ዛሬባ
sprite	zrt	ዛርቲ
shaft	zbj	ዛብያ
story	znt	ዛንታ
account	znt	ዛንታ
agenda	zʕb	ዛዕባ
leakage	zʕɡ	ዛዕጊ
bind	zzm	ዛዘመ
list	zzw	ዛዘወ
outreach	zjd	ዛየደ
pheasant	zɡr	ዛግራ
cool	zhm	ዝሁም
slack	zlqʰ	ዝሉቕ
cold	zħl	ዝሑል
cool	zħl	ዝሑል
better	zħʃ	ዝሓሸ
adultery	zmt	ዝሙት
loot	zmt	ዝምታ
piracy	zmt	ዝምታ
pervert	zrɡ	ዝሩግ
rake	zrɡ	ዝሩግ
dissemination	zrw	ዝርዋ
surface	zbn	ዝባን
back	zbn	ዝባን
era	zbn	ዝባን...
hyena	zbʔ	ዝብኢ
rain	znb	ዝናብ
rainfall	znb	ዝናብ
present	zkr	ዝኩር
commemoration	zkr	ዝክር
memorial	zxr	ዝኽሪ
memory	zxr	ዝኽሪ
tribute	zxr	ዝኽሪ
giraffe	zʕt	ዝዖታ
margin	zjd	ዝያዳ
excess	zjd	ዝያዳ
over	zjd	ዝያዳ
surplus	zjd	ዝያዳ
superior	zjd	ዝያዳ
residue	zɡt	ዝግታ
spiced	zɡn	ዝግኒ
vernacular	zbw	ዞባዊ
educator	jnt	የኔታ
pigeon	jwh	የዋህ
angel	jwh	የዋህ
yawl	jwl	ያውል
communication	jjm	ይይም
discussion	jjm	ይይም
jonah	jns	ዮናስ
tone	dhj	ደሃይ
voice	dhj	ደሃይ
gain	dlb	ደለበ
ferret	dlj	ደለየ
fish	dlj	ደለየ
want	dlj	ደለየ
wish	dlj	ደለየ
will	dlj	ደለየ
quest	dlj	ደለየ
hunt	dlj	ደለየ
like	dlj	ደለየ
search	dlj	ደለየ
residuum	dll	ደላሊ
aspirant	dlj	ደላዪ
delta	dlt	ደልታ
lag	dħr	ደሓረ
aggregate	dmr	ደመረ
total	dmr	ደመረ
belle	dmt	ደመት
magnetism	dmt	ደመት
beauty	dmt	ደመት
corral	dmb	ደምበ
pay	dmz	ደሞዝ
salary	dmz	ደሞዝ
stipend	dmz	ደሞዝ
graduate	drd͡ʒ	ደረ'ጀ
quilt	drb	ደረበ
limit	drt	ደረተ
qualification	drt	ደረት
limitation	drt	ደረት
chest	drt	ደረት
demarcation	drt	ደረት
edge	drt	ደረት
threshold	drt	ደረት
stint	drt	ደረት
breast	drt	ደረት
border	drt	ደረት
boundary	drt	ደረት
force	drx	ደረኸ
dab	drz	ደረዘ
extent	drd͡ʒ	ደረጃ
step	drd͡ʒ	ደረጃ
grade	drd͡ʒ	ደረጃ
standing	drd͡ʒ	ደረጃ
status	drd͡ʒ	ደረጃ
state	drd͡ʒ	ደረጃ
hierarchy	drd͡ʒ	ደረጃ
phase	drd͡ʒ	ደረጃ
rating	drd͡ʒ	ደረጃ
rank	drd͡ʒ	ደረጃ
stage	drd͡ʒ	ደረጃ
rate	drd͡ʒ	ደረጃ
norm	drd͡ʒ	ደረጃ
degree	drd͡ʒ	ደረጃ
laureate	drs	ደራሲ
writer	drs	ደራሲ
author	drs	ደራሲ
factor	drx	ደራኺ
massage	drz	ደራዚ
singer	drf	ደራፊ
poultry	drh	ደርሆ
chicken	drh	ደርሆ
farm	drh	ደርሆ
class	drb	ደርቢ
estate	drb	ደርቢ
stratum	drb	ደርቢ
dirk	drk	ደርክ
thump	drʕ	ደርዐ
uniform	drɡ	ደርጊ
song	drf	ደርፊ
cloud	drn	ደሮና
thump	dsqʰ	ደሰቓ
island	dst	ደሴት
isle	dst	ደሴት
exhilaration	dst	ደስታ
happiness	dst	ደስታ
satisfaction	dst	ደስታ
complacency	dst	ደስታ
comfort	dst	ደስታ
elation	dst	ደስታ
joy	dst	ደስታ
sleep	dqs	ደቀሰ
atom	dqq	ደቂቅ
micro	dqqʰ	ደቂቕ
sleeper	dqs	ደቃሲ
minute	dqʰqʰ	ደቒቕ
squash	dqʰʷs	ደቘሰ
stamp	dqʰʷs	ደቘሰ
despot	dqʰʷs	ደቛሲ
condolence	dbs	ደበሰ
console	dbs	ደበሰ
condolence	dbs	ደበስ
cloud	dbn	ደበና
south	dbb	ደቡብ
havoc	dbb	ደቡብ
matt	dbn	ደባን
oasis	dbr	ደብሪ
ranch	dnb	ደንበ
compost	dkʷʕ	ደኰዐ
strain	dxm	ደኸመ
lease	dxj	ደኸየ
chime	dwl	ደወለ
dial	dwl	ደወለ
phone	dwl	ደወለ
call	dwl	ደወለ
stroke	dwl	ደወል
bell	dwl	ደወል
chime	dwl	ደወል
ferret	dwr	ደወረ
hunt	dwr	ደወረ
bell	dwl	ደውል
rise	djb	ደየበ
climb	djb	ደየበ
rear	dd͡ʒn	ደጀን
review	dɡm	ደገመ
repeat	dɡm	ደገመ
aid	dɡf	ደገፈ
prop	dɡf	ደገፈ
advocate	dɡf	ደገፈ
champion	dɡf	ደገፈ
assist	dɡf	ደገፈ
hurrah	dɡf	ደገፍ
assistance	dɡf	ደገፍ
reinforcement	dɡf	ደገፍ
solidarity	dɡf	ደገፍ
vomit	dɡħ	ደጉሐ
dazzle	dɡħ	ደጉሐ
dirge	dɡʕ	ደጉዐ
adherent	dɡf	ደጋፊ
supporter	dɡf	ደጋፊ
fan	dɡf	ደጋፊ
assistant	dɡf	ደጋፊ
advocate	dɡf	ደጋፊ
fun	dɡf	ደጋፊ
follower	dɡf	ደጋፊ
pro	dɡf	ደጋፊ
partisan	dɡf	ደጋፊ
relapse	dɡs	ደግሲ
highland	dɡʕ	ደግዓ
dare	dfr	ደፈረ
venture	dfr	ደፈረ
default	dfn	ደፈነ
propeller	dfʔ	ደፋኢ
press	dfʔ	ደፍአ
push	dfʔ	ደፍአ
shoulder	dfʔ	ደፍአ
hustle	dfʔ	ደፍአ
shove	dfʔ	ደፍአ
domino	dmn	ዱምና
thud	dbt	ዱብታ
thunderbolt	dbl	ዱቦላ
thud	dt͡ʃʼt	ዱጭታ
disc	dsk	ዲስኮ
disk	dsk	ዲስኮ
disco	dsk	ዲስኮ
generator	dnm	ዲናሞ
dynamo	dnm	ዲናሞ
twang	dwt	ዲውታ
diesel	dzl	ዲዘል
degree	dɡr	ዲግሪ
bonfire	dmr	ዳሜራ
stratum	drb	ዳርባ
pole	dqʰj	ዳቕያ
judge	dnj	ዳነየ
referee	dnj	ዳነየ
umpire	dnj	ዳነየ
dolt	dnd	ዳንደ
dunce	dnd	ዳንደ
shank	dnɡ	ዳንጋ
sycamore	dʕr	ዳዕሮ
tribunal	djn	ዳያኑ
dime	djm	ዳይም
prop	dɡf	ዳጌፋ
replica	dɡm	ዳግም
dogma	dɡm	ዳግም
coop	dɡn	ዳጎነ
cage	dɡn	ዳጎነ
corral	dɡn	ዳጎነ
red	dsw	ዴሳዊ
storage	dlb	ድለባ
wish	dlt	ድሌት
will	dlt	ድሌት
desire	dlt	ድሌት
aspiration	dlt	ድሌት
love	dlt	ድሌት
need	dlt	ድሌት
search	dlj	ድልያ
post	dħr	ድሕሪ
totality	dmr	ድምር
addition	dmr	ድምር
total	dmr	ድምር
sum	dmr	ድምር
amount	dmr	ድምር
blare	dmt͡sʼ	ድምጺ
voice	dmt͡sʼ	ድምጺ
sound	dmt͡sʼ	ድምጺ
stark	drqʰ	ድሩቕ
pageant	drm	ድራማ
drama	drm	ድራማ
dinner	drr	ድራር
constraint	drx	ድራኸ
dab	drz	ድራዞ
drug	drɡ	ድራግ
drought	drq	ድርቂ
dryness	drq	ድርቂ
fodder	drqʷ	ድርቋ
drought	drqʷ	ድርቋ
hay	drqʷ	ድርቋ
double	drb	ድርብ
bi	drb	ድርብ
impetus	drk	ድርኪ
influence	drk	ድርኪ
mail	drʕ	ድርዒ
armature	drʕ	ድርዒ
shell	drʕ	ድርዒ
gay	dst	ድሱት
saucepan	dst	ድስቲ
pot	dst	ድስቲ
mongrel	dql	ድቃ'ል
replica	dql	ድቃል
copy	dql	ድቃል
rest	dqs	ድቃስ
sleep	dqs	ድቃስ
hybrid	dqʰl	ድቓላ
bastard	dqʰl	ድቓላ
sediment	dbt	ድበት
string	dbr	ድባራ
cord	dbr	ድባራ
fog	dbn	ድባነ
paralysis	dnʃ	ድንሽ
murphy	dnʃ	ድንሽ
potato	dnʃ	ድንሽ
prodigy	dnq	ድንቂ
capital	dnq	ድንቂ
dwarf	dnk	ድንኪ
cog	dkl	ድካለ
tent	dkʷn	ድኳን
store	dkʷn	ድኳን
shop	dkʷn	ድኳን
grocery	dkʷn	ድኳን
compost	dxʕ	ድኹዒ
fertilizer	dxʕ	ድኹዒ
muck	dxʕ	ድኹዒ
pain	dxm	ድኻም
impotence	dxm	ድኻም
incapacity	dxm	ድኻም
disability	dxm	ድኻም
duet	dwt	ድወት
batter	dws	ድዋስ
leper	dwj	ድውይ
ram	dʕl	ድዑል
ascendancy	djb	ድያበ
iteration	dɡm	ድግማ
repeat	dɡm	ድግማ
blind	dfn	ድፉን
hedgehog	dfʕ	ድፋዕ
stronghold	dfʕ	ድፋዕ
dollar	dlr	ዶላር
pastry	dlʃ	ዶልሺ
cake	dlʃ	ዶልሺ
dust	drn	ዶሮና
boat	d͡ʒlb	ጀለበ
cox	d͡ʒlb	ጀለበ
pull	d͡ʒlb	ጀለበ
domain	d͡ʒltʼ	ጀለጠ
cox	d͡ʒlb	ጀላቢ
attempt	d͡ʒmr	ጀመረ
launch	d͡ʒmr	ጀመረ
start	d͡ʒmr	ጀመረ
go	d͡ʒmr	ጀመረ
novice	d͡ʒmr	ጀማሪ
beginner	d͡ʒmr	ጀማሪ
scan	d͡ʒrb	ጀረበ
chicken	d͡ʒrqʰʷ	ጀራቝ
funk	d͡ʒrqʰʷ	ጀራቝ
yellow	d͡ʒrqʰʷ	ጀራቝ
stab	d͡ʒqʰt	ጀቐተ
cheese	d͡ʒbn	ጀብና
bandage	d͡ʒnn	ጀነነ
bind	d͡ʒnn	ጀነነ
incident	d͡ʒdj	ጀደይ
hero	d͡ʒɡn	ጀግና
heroic	d͡ʒɡn	ጀግና
hilt	d͡ʒjm	ጂየም
gypsy	d͡ʒps	ጂፕሲ
pretension	d͡ʒhr	ጃህራ
lighter	d͡ʒlb	ጃልባ
boat	d͡ʒlb	ጃልባ
cutter	d͡ʒlb	ጃልባ
junk	d͡ʒlb	ጃልባ
clout	d͡ʒnd	ጃንዳ
timber	d͡ʒnd	ጃንዳ
coat	d͡ʒkt	ጃኬት
tunic	d͡ʒkt	ጃኬት
jacket	d͡ʒkt	ጃኬት
jaguar	d͡ʒɡʷr	ጃጓር
row	d͡ʒlb	ጅላበ
tendon	d͡ʒmt	ጅማት
sentence	d͡ʒml	ጅምላ
canvas	d͡ʒrb	ጅርባ
cheese	d͡ʒbn	ጅብና
flurry	d͡ʒwt	ጅውታ
hero	d͡ʒɡn	ጅግና
craven	d͡ʒrqʰ	ጆራቕ
joker	d͡ʒkr	ጆከር
stampede	ɡlb	ገለበ
phrase	ɡlt͡sʼ	ገለጸ
express	ɡlt͡sʼ	ገለጸ
annunciation	ɡlt͡sʼ	ገለጻ
predicate	ɡlt͡sʼ	ገላጺ
exponent	ɡlt͡sʼ	ገላጺ
beam	ɡml	ገመል
timber	ɡml	ገመል
camel	ɡml	ገመል
half	ɡms	ገመሰ
think	ɡmt	ገመተ
account	ɡmt	ገመተ
estimate	ɡmt	ገመተ
feel	ɡmt	ገመተ
say	ɡmt	ገመተ
regard	ɡmt	ገመተ
guess	ɡmt	ገመተ
value	ɡmt	ገመተ
strand	ɡmd	ገመድ
string	ɡmd	ገመድ
rope	ɡmd	ገመድ
mace	ɡmd	ገመድ
speculator	ɡmt	ገማቲ
carcass	ɡmb	ገምቢ
bang	ɡmt	ገምታ
slam	ɡmt	ገምታ
wood	ɡrb	ገረብ
tree	ɡrb	ገረብ
forest	ɡrb	ገረብ
grove	ɡrb	ገረብ
woody	ɡrb	ገረብ
concubine	ɡrd	ገረድ
frank	ɡrh	ገርሂ
angel	ɡrh	ገርሂ
lint	ɡrz	ገርዚ
panel	ɡrz	ገርዚ
portico	ɡbl	ገበላ
lobby	ɡbl	ገበላ
outhouse	ɡbl	ገበላ
vestibule	ɡbl	ገበላ
boa	ɡbl	ገበል
python	ɡbl	ገበል
anachronism	ɡbl	ገበል
shoe	ɡbr	ገበረ
wage	ɡbr	ገበረ
make	ɡbr	ገበረ
act	ɡbr	ገበረ
sheath	ɡbr	ገበር
jacket	ɡbr	ገበር
malpractice	ɡbn	ገበን
crime	ɡbn	ገበን
felony	ɡbn	ገበን
enormity	ɡbn	ገበን
doer	ɡbr	ገባሪ
maker	ɡbr	ገባሪ
check	ɡtʔ	ገታኢ
dam	ɡtʔ	ገትአ
paradise	ɡnt	ገነት
eden	ɡnt	ገነት
shroud	ɡnz	ገነዘ
vat	ɡnʔ	ገንኢ
bang	ɡwt	ገውታ
porridge	ɡʕt	ገዓት
hulk	ɡzf	ገዚፍ
governor	ɡzʔ	ገዛኢ
dowry	ɡzm	ገዝሚ
dot	ɡzm	ገዝሚ
buy	ɡzʔ	ገዝአ
rule	ɡzʔ	ገዝአ
passenger	ɡjʃ	ገያሺ
voyager	ɡjʃ	ገያሺ
cliff	ɡdl	ገደል
dam	ɡdb	ገደበ
limit	ɡdb	ገደብ
compulsion	ɡdd	ገደደ
leave	ɡdf	ገደፈ
veteran	ɡdm	ገዲም
cloister	ɡdm	ገዳም
effort	ɡdl	ገድሊ
epic	ɡdl	ገድሊ
war	ɡdl	ገድሊ
face	ɡtʼm	ገጠመ
fit	ɡtʼm	ገጠመ
countryside	ɡtʼr	ገጠር
country	ɡtʼr	ገጠር
poet	ɡtʼm	ገጣሚ
jar	ɡt͡ʃʼw	ገጨወ
bran	ɡfl	ገፈል
fish	ɡff	ገፈፈ
skim	ɡff	ገፈፈ
dale	ɡfħ	ገፊሕ
aggressor	ɡfʕ	ገፋዒ
atrocity	ɡfʕ	ገፍዐ
gross	ɡlħ	ጉሉሕ
estate	ɡlt	ጉልቲ
fee	ɡlt	ጉልቲ
bandit	ɡħl	ጉሒላ
fraud	ɡħl	ጉሒላ
hippopotamus	ɡmr	ጉማረ
sword	ɡrd	ጉራደ
hilt	ɡrd	ጉራድ
sword	ɡrd	ጉራድ
sword	ɡrd	ጉራዶ
wile	ɡrħ	ጉርሒ
guile	ɡrħ	ጉርሒ
evasion	ɡsj	ጉስያ
stroke	ɡstʼ	ጉስጢ
clout	ɡstʼ	ጉስጢ
clip	ɡstʼ	ጉስጢ
buffet	ɡstʼ	ጉስጢ
sock	ɡstʼ	ጉስጢ
duty	ɡbʔ	ጉቡእ
convocation	ɡbʔ	ጉባኤ
assembly	ɡbʔ	ጉባኤ
congress	ɡbʔ	ጉባኤ
ear	ɡnb	ጉንቦ
log	ɡnd	ጉንዲ
trunk	ɡnd	ጉንዲ
stem	ɡnd	ጉንዲ
owl	ɡnɡʷ	ጉንጓ
cheek	ɡnt͡ʃʼ	ጉንጪ
metal	ɡʕr	ጉዑር
journey	ɡʕz	ጉዕዞ
trip	ɡʕz	ጉዕዞ
passage	ɡʕz	ጉዕዞ
progress	ɡʕz	ጉዕዞ
lack	ɡdl	ጉዳል
shortage	ɡdl	ጉዳል
case	ɡdj	ጉዳይ
business	ɡdj	ጉዳይ
question	ɡdj	ጉዳይ
affair	ɡdj	ጉዳይ
item	ɡdj	ጉዳይ
batch	ɡd͡ʒl	ጉጅለ
cluster	ɡd͡ʒl	ጉጅለ
kind	ɡd͡ʒl	ጉጅለ
crew	ɡd͡ʒl	ጉጅለ
crop	ɡd͡ʒl	ጉጅለ
corps	ɡd͡ʒl	ጉጅለ
coterie	ɡd͡ʒl	ጉጅለ
college	ɡd͡ʒl	ጉጅለ
group	ɡd͡ʒl	ጉጅለ
phalanx	ɡd͡ʒl	ጉጅለ
troupe	ɡd͡ʒl	ጉጅለ
school	ɡd͡ʒl	ጉጅለ
gang	ɡd͡ʒl	ጉጅለ
crowd	ɡd͡ʒl	ጉጅለ
pincers	ɡtʼt	ጉጤት
slave	ɡlj	ጊልያ
thrall	ɡlj	ጊልያ
guitar	ɡtr	ጊታር
freak	ɡntʼ	ጊንጢ
pit	ɡhs	ጋህሲ
frank	ɡhd	ጋህዲ
peck	ɡln	ጋሎን
gallon	ɡln	ጋሎን
shutter	ɡrd	ጋራዲ
garage	ɡrd͡ʒ	ጋራጅ
cab	ɡbn	ጋቢ'ና
cab	ɡbn	ጋቢና
cabin	ɡbn	ጋቢና
basin	ɡbl	ጋብላ
tub	ɡbl	ጋብላ
kennel	ɡbj	ጋብያ
coop	ɡbj	ጋብያ
cage	ɡbj	ጋብያ
goblin	ɡnn	ጋኔን
spirit	ɡnn	ጋኔን
team	ɡnt	ጋንታ
squad	ɡnt	ጋንታ
troupe	ɡnt	ጋንታ
discovery	ɡnt	ጋንታ
platoon	ɡnt	ጋንታ
gang	ɡnt	ጋንታ
thatch	ɡʕs	ጋዕሲ
relocation	ɡʕz	ጋዕዚ
paper	ɡztʼ	ጋዜጣ
newspaper	ɡztʼ	ጋዜጣ
journal	ɡztʼ	ጋዜጣ
mouthpiece	ɡztʼ	ጋዜጣ
beau	ɡt͡sʼɲ	ጌጸኛ
frank	ɡhd	ግሁድ
isolation	ɡll	ግለላ
island	ɡll	ግሉል
secret	ɡll	ግሉል
recluse	ɡll	ግሉል
outsider	ɡll	ግሉል
patent	ɡlt͡sʼ	ግሉጽ
individual	ɡlw	ግላዊ
block	ɡlʕ	ግላዕ
chunk	ɡlz	ግላዝ
blade	ɡlz	ግላዝ
stampede	ɡlb	ግልባ
plain	ɡlt͡sʼ	ግልጺ
globe	ɡlb	ግሎብ
sphere	ɡlb	ግሎብ
chunk	ɡmd	ግማ'ድ
section	ɡmʕ	ግማዕ
chunk	ɡmd	ግማድ
tower	ɡmb	ግምቢ
castle	ɡmb	ግምቢ
hypothesis	ɡmt	ግምት
assumption	ɡmt	ግምት
opinion	ɡmt	ግምት
guess	ɡmt	ግምት
estimation	ɡmt	ግምት
treasury	ɡmd͡ʒ	ግምጃ
chest	ɡmd͡ʒ	ግምጃ
treasure	ɡmd͡ʒ	ግምጃ
marvel	ɡrm	ግሩ'ም
wonder	ɡrm	ግራ'መ
gram	ɡrm	ግራም
grease	ɡrs	ግራሶ
field	ɡrt	ግራት
grey	ɡrt͡ʃʼ	ግራጫ
tang	ɡrt͡ʃʼ	ግራጭ
graph	ɡrf	ግራፍ
grace	ɡrm	ግርማ
trappings	ɡrm	ግርማ
fair	ɡrm	ግርም
grand	ɡrm	ግርም
good	ɡrm	ግርም
panther	ɡsl	ግስላ
confiscation	ɡbt	ግበ'ታ
conscription	ɡbt	ግበ'ታ
duty	ɡbʔ	ግቡእ
quota	ɡbʔ	ግቡእ
rebate	ɡbr	ግብሪ
toll	ɡbr	ግብሪ
tax	ɡbr	ግብሪ
practice	ɡbr	ግብሪ
tribute	ɡbr	ግብሪ
taxation	ɡbr	ግብሪ
reception	ɡbd͡ʒ	ግብጃ
entertainment	ɡbd͡ʒ	ግብጃ
monster	ɡnj	ግናይ
rook	ɡnb	ግንቢ
melee	ɡʕr	ግዒሮ
slave	ɡzʔ	ግዙእ
tributary	ɡzʔ	ግዙእ
thrall	ɡzʔ	ግዙእ
titanic	ɡzf	ግዙፍ
macro	ɡzf	ግዙፍ
stuff	ɡzʕ	ግዛዕ
thing	ɡzʕ	ግዛዕ
anathema	ɡzt	ግዝት
moth	ɡzw	ግዝዋ
size	ɡzf	ግዝፊ
magnitude	ɡzf	ግዝፊ
immensity	ɡzf	ግዝፊ
bulk	ɡzf	ግዝፊ
coterie	ɡds	ግዱስ
outdoors	ɡdm	ግዳም
outside	ɡdm	ግዳም
victim	ɡdj	ግዳይ
target	ɡdj	ግዳይ
compulsion	ɡdd	ግዳደ
coercion	ɡdd	ግዳደ
constraint	ɡdd	ግዳደ
obligation	ɡdt	ግዴታ
liability	ɡdt	ግዴታ
problem	ɡdl	ግድል
proposition	ɡdl	ግድል
puzzle	ɡdl	ግድል
barrage	ɡdb	ግድብ
dam	ɡdb	ግድብ
wrong	ɡɡj	ግጉይ
fit	ɡtʼm	ግጡም
bout	ɡtʼm	ግጥ'ም
verse	ɡtʼm	ግጥሚ
poem	ɡtʼm	ግጥሚ
poetry	ɡtʼm	ግጥሚ
game	ɡtʼm	ግጥም
combat	ɡtʼm	ግጥም
meeting	ɡtʼm	ግጥም
competition	ɡtʼm	ግጥም
conflict	ɡt͡ʃʼt	ግጭት
discrepancy	ɡt͡ʃʼt	ግጭት
percussion	ɡt͡ʃʼt	ግጭት
impact	ɡt͡ʃʼt	ግጭት
scum	ɡff	ግፋፍ
width	ɡfħ	ግፍሒ
amplitude	ɡfħ	ግፍሒ
atrocity	ɡfʕ	ግፍዒ
aggression	ɡfʕ	ግፍዒ
golf	ɡlf	ጎልፍ
sweater	ɡlf	ጎልፍ
sweater	ɡlf	ጎልፎ
jersey	ɡlf	ጎልፎ
refuse	ɡħf	ጎሓፍ
waste	ɡħf	ጎሓፍ
tee	ɡmm	ጎመመ
gorilla	ɡrl	ጎሪላ
adolescent	ɡrz	ጎርዞ
throat	ɡrr	ጎሮሮ
trail	ɡss	ጎሰሰ
tug	ɡss	ጎሰሰ
warp	ɡbtʼ	ጎበ'ጠ
hypocrite	ɡbz	ጎበዝ
swain	ɡbz	ጎበዝ
annex	ɡbtʼ	ጎበጠ
buffalo	ɡbj	ጎባይ
tortoise	ɡbj	ጎብየ
cage	ɡbj	ጎብያ
tow	ɡtt	ጎተተ
trail	ɡtt	ጎተተ
hale	ɡtt	ጎተተ
laggard	ɡtt	ጎታት
shove	ɡnt͡sʼ	ጎነጸ
aggression	ɡnt͡sʼ	ጎነጸ
violence	ɡnt͡sʼ	ጎነጽ
disease	ɡnf	ጎነፈ
shock	ɡnt͡sʼ	ጎንጺ
shove	ɡnt͡sʼ	ጎንጺ
booty	ɡzj	ጎዘየ
bill	ɡzm	ጎዞሞ
runner	ɡjj	ጎያዩ
lord	ɡjt	ጎይታ
outskirts	ɡdb	ጎደቦ
suburbs	ɡdb	ጎደቦ
street	ɡdn	ጎደና
width	ɡdn	ጎድኒ
hurt	ɡdʔ	ጎድአ
abuse	ɡdʔ	ጎድአ
damage	ɡdʔ	ጎድአ
glow	ɡʷhr	ጐሃረ
harry	ɡʷħl	ጐሓለ
discard	ɡʷħf	ጐሓፈ
dump	ɡʷħf	ጐሓፈ
dust	ɡʷħf	ጐሓፍ
garbage	ɡʷħf	ጐሓፍ
scum	ɡʷħf	ጐሓፍ
junk	ɡʷħf	ጐሓፍ
punk	ɡʷħf	ጐሓፍ
trash	ɡʷħf	ጐሓፍ
hack	ɡʷmd	ጐመደ
throat	ɡʷrr	ጐረሮ
snake	ɡʷrħ	ጐራሕ
maiden	ɡʷrz	ጐርዞ
lug	ɡʷss	ጐሰሰ
swoop	ɡʷbtʼ	ጐበጠ
annexation	ɡʷbtʼ	ጐበጣ
draw	ɡʷtt	ጐተተ
pull	ɡʷtt	ጐተተ
push	ɡʷnt͡sʼ	ጐነጸ
encounter	ɡʷnf	ጐነፈ
run	ɡʷjj	ጐየየ
chase	ɡʷjj	ጐየየ
runner	ɡʷjj	ጐያዪ
boss	ɡʷjt	ጐይታ
don	ɡʷjt	ጐይታ
allowance	ɡʷdl	ጐደል
short	ɡʷdl	ጐደሎ
grasshopper	ɡʷdb	ጐደበ
road	ɡʷdn	ጐደና
avenue	ɡʷdn	ጐደና
thoroughfare	ɡʷdn	ጐደና
route	ɡʷdn	ጐደና
street	ɡʷdn	ጐደና
boulevard	ɡʷdn	ጐደና
ill	ɡʷdʔ	ጐዳኢ
side	ɡʷdn	ጐድኒ
pestle	ɡʷdʔ	ጐድአ
bite	ɡʷdʔ	ጐድአ
harm	ɡʷdʔ	ጐድአ
damage	ɡʷdʔ	ጐድአ
divide	ɡʷd͡ʒl	ጐጀለ
sort	ɡʷd͡ʒl	ጐጀለ
nudge	ɡʷtʼj	ጐጠየ
poke	ɡʷtʼj	ጐጠየ
jolt	ɡʷt͡sʼt	ጐጽታ
cinder	ɡʷhr	ጓህሪ
club	ɡʷmd	ጓመድ
shepherd	ɡʷsj	ጓሰየ
vacuum	ɡʷnɡʷ	ጓንጓ
hollow	ɡʷnɡʷ	ጓንጓ
party	ɡʷjl	ጓይላ
thief	ɡʷħl	ጕሒላ
honeycomb	ɡʷrɲ	ጕረኛ
fail	tʼlm	ጠለመ
desert	tʼlm	ጠለመ
sink	tʼlqʰ	ጠለቐ
claim	tʼlb	ጠለበ
demand	tʼlb	ጠለበ
requirement	tʼlb	ጠለብ
knit	tʼlf	ጠለፈ
rat	tʼlm	ጠላም
gamble	tʼlʕ	ጠላዕ
sink	tʼħl	ጠሓለ
founder	tʼħl	ጠሓለ
pierce	tʼħs	ጠሓሰ
storm	tʼħs	ጠሓሰ
miller	tʼħn	ጠሓኒ
bind	tʼmr	ጠመረ
strap	tʼmr	ጠመረ
pin	tʼmr	ጠመረ
tie	tʼmr	ጠመረ
glance	tʼmt	ጠመተ
face	tʼmt	ጠመተ
hunger	tʼmj	ጠመየ
pickle	tʼrʃ	ጠረሸ
transport	tʼrz	ጠረዘ
cashier	tʼrz	ጠረዘ
frontier	tʼrf	ጠረፍ
extreme	tʼrf	ጠረፍ
petition	tʼrʕ	ጠርዐ
report	tʼrʕ	ጠርዐ
butter	tʼsm	ጠሰመ
cream	tʼsm	ጠስሚ
butter	tʼsm	ጠስሚ
thyme	tʼsn	ጠስነ
placard	tʼqʕ	ጠቀዐ
coon	tʼqr	ጠቃር
advantage	tʼqʰm	ጠቐመ
benefit	tʼqʰm	ጠቐመ
mention	tʼqʰs	ጠቐሰ
paste	tʼqʰʕ	ጠቐዐ
lizard	tʼbqʰ	ጠበ'ቕ
cajole	tʼbr	ጠበረ
grill	tʼbs	ጠበሰ
fry	tʼbs	ጠበሰ
fuse	tʼbqʰ	ጠበቐ
prophet	tʼbqʰ	ጠበቓ
advocate	tʼbqʰ	ጠበቓ
lawyer	tʼbqʰ	ጠበቓ
counsel	tʼbqʰ	ጠበቓ
attorney	tʼbqʰ	ጠበቓ
solicitor	tʼbqʰ	ጠበቓ
lizard	tʼbqʰ	ጠበቕ
artisan	tʼbb	ጠቢብ
artist	tʼbb	ጠቢብ
smith	tʼbb	ጠቢብ
adhesive	tʼbqʰ	ጠባቒ
sticker	tʼbqʰ	ጠባቒ
sucker	tʼbw	ጠባዊ
conduct	tʼbj	ጠባይ
feature	tʼbj	ጠባይ
nature	tʼbj	ጠባይ
behaviour	tʼbj	ጠባይ
element	tʼbj	ጠባይ
kidney	tʼbj	ጠባይ
disposition	tʼbj	ጠባይ
quality	tʼbj	ጠባይ
attitude	tʼbj	ጠባይ
property	tʼbj	ጠባይ
subject	tʼnq	ጠንቂ
cause	tʼnq	ጠንቂ
seed	tʼnq	ጠንቂ
touch	tʼwqʰ	ጠወቐ
push	tʼwqʰ	ጠወቐ
twist	tʼwj	ጠወየ
twine	tʼwj	ጠወየ
flex	tʼwj	ጠወየ
screw	tʼwj	ጠወየ
bias	tʼwj	ጠወየ
curve	tʼwj	ጠወየ
questioner	tʼjqʰ	ጠያቒ
applicant	tʼjqʰ	ጠያቒ
brew	tʼd͡ʒʔ	ጠጅአ
stew	tʼtʼqʰ	ጠጠቐ
sphere	tʼfr	ጠፈር
atmosphere	tʼfr	ጠፈር
space	tʼfr	ጠፈር
twang	tʼnt	ጢንታ
card game	tʼlʕ	ጣላዕ
intervention	tʼlq	ጣልቃ
mosquito	tʼntʼ	ጣንጡ
fetish	tʼʔt	ጣኦት
idol	tʼʔt	ጣኦት
board	tʼwl	ጣውላ
table	tʼwl	ጣውላ
peacock	tʼws	ጣውስ
taste	tʼʕm	ጣዐሚ
luxury	tʼʕm	ጣዐሚ
taste	tʼʕm	ጣዕሚ
luxury	tʼʕm	ጣዕሚ
compunction	tʼʕs	ጣዕሳ
contrition	tʼʕs	ጣዕሳ
mode	tʼrr	ጤረር
ridge	tʼrr	ጤረር
top	tʼrr	ጤረር
acme	tʼrf	ጤረፍ
rage	tʼlb	ጥሉብ
sop	tʼlqʰ	ጥላ'ቕ
motif	tʼlf	ጥልፊ
bale	tʼmr	ጥማር
bunch	tʼmr	ጥማር
bundle	tʼmr	ጥማር
rope	tʼmr	ጥማር
cog	tʼmt	ጥማተ
sop	tʼmʕ	ጥማዕ
hunger	tʼmt	ጥሜት
batch	tʼmr	ጥምሮ
sheaf	tʼmr	ጥምሮ
bunch	tʼmr	ጥምሮ
package	tʼmr	ጥምሮ
packet	tʼmr	ጥምሮ
extreme	tʼrf	ጥሩፍ
possession	tʼrt	ጥሪት
estate	tʼrt	ጥሪት
livestock	tʼrt	ጥሪት
wealth	tʼrt	ጥሪት
pad	tʼrz	ጥራዝ
notebook	tʼrz	ጥራዝ
vacuum	tʼrj	ጥራዩ
blank	tʼrj	ጥራዩ
void	tʼrħ	ጥርሑ
blank	tʼrħ	ጥርሑ
pickle	tʼrʃ	ጥርሺ
bit	tʼrq	ጥርቂ
ridge	tʼrz	ጥርዚ
culmination	tʼrz	ጥርዚ
apex	tʼrz	ጥርዚ
retreat	tʼrt	ጥሮታ
retirement	tʼrt	ጥሮታ
imputation	tʼqn	ጥቀና
recipient	tʼqʰm	ጥቕሚ
vantage	tʼqʰm	ጥቕሚ
overlap	tʼqʰm	ጥቕሚ
worth	tʼqʰm	ጥቕሚ
utility	tʼqʰm	ጥቕሚ
welfare	tʼqʰm	ጥቕሚ
benefit	tʼqʰm	ጥቕሚ
citation	tʼqʰs	ጥቕሲ
tag	tʼqʰs	ጥቕሲ
logo	tʼqʰs	ጥቕሲ
wizard	tʼbb	ጥበቡ
craft	tʼbb	ጥበብ
art	tʼbb	ጥበብ
technique	tʼbb	ጥበብ
wisdom	tʼbb	ጥበብ
skill	tʼbb	ጥበብ
artifice	tʼbb	ጥበብ
knack	tʼbb	ጥበብ
shirt	tʼbq	ጥቢቆ
incision	tʼbħ	ጥባሕ
fixture	tʼbqʰ	ጥባቕ
grill	tʼbs	ጥብሲ
appendix	tʼbq	ጥብቆ
adjunct	tʼbq	ጥብቆ
pregnancy	tʼns	ጥንሲ
swirl	tʼwj	ጥዋይ
candle	tʼwf	ጥዋፍ
taper	tʼwf	ጥዋፍ
curve	tʼwj	ጥውዮ
loop	tʼwj	ጥውዮ
nice	tʼʕm	ጥዑም
primer	tʼʕm	ጥዑም
whole	tʼʕj	ጥዑይ
health	tʼʕn	ጥዕና
ping	tʼzt	ጥዝታ
query	tʼjqʰ	ጥያቐ
inquest	tʼjqʰ	ጥያቐ
inquiry	tʼjqʰ	ጥያቔ
bullet	tʼjt	ጥይት
slur	tʼtʼħ	ጥጣሐ
comfort	tʼtʼħ	ጥጣሐ
failure	tʼfʃ	ጥፈሻ
bankruptcy	tʼfʃ	ጥፈሻ
scoop	t͡ʃʼlf	ጨለፈ
ladle	t͡ʃʼlf	ጨለፈ
snap	t͡ʃʼmt	ጨመተ
marksman	t͡ʃʼmt	ጨማቲ
nibble	t͡ʃʼrm	ጨረመ
banter	t͡ʃʼrqʰ	ጨረቐ
rally	t͡ʃʼrqʰ	ጨረቐ
auction	t͡ʃʼrt	ጨረታ
jester	t͡ʃʼrqʰ	ጨራቒ
auctioneer	t͡ʃʼrt	ጨራቲ
holler	t͡ʃʼrħ	ጨርሐ
barrow	t͡ʃʼrħ	ጨርሒ
cloth	t͡ʃʼrq	ጨርቂ
oppressor	t͡ʃʼqʷn	ጨቋኒ
grip	t͡ʃʼbtʼ	ጨበጠ
gulp	t͡ʃʼbtʼ	ጨበጠ
stink	t͡ʃʼnw	ጨነወ
savage	t͡ʃʼkn	ጨካን
oppressor	t͡ʃʼkn	ጨካን
beast	t͡ʃʼkn	ጨካን
kidnap	t͡ʃʼwj	ጨወየ
lisp	t͡ʃʼjf	ጨየፈ
snarl	t͡ʃʼdr	ጨደረ
thunder	t͡ʃʼdr	ጨደረ
bellow	t͡ʃʼdr	ጨደረ
blare	t͡ʃʼdr	ጨደረ
hoop	t͡ʃʼdr	ጨደረ
storm	t͡ʃʼdr	ጨደረ
split	t͡ʃʼdd	ጨደደ
lance	t͡ʃʼdd	ጨደደ
crevice	t͡ʃʼdd	ጨዳድ
crack	t͡ʃʼdd	ጨዳድ
crevasse	t͡ʃʼdd	ጨዳድ
hair	t͡ʃʼɡr	ጨጉሪ
stomach	t͡ʃʼɡr	ጨጎራ
maw	t͡ʃʼɡʷr	ጨጐራ
pod	t͡ʃʼt͡ʃʼf	ጨጨፈ
bog	t͡ʃʼfq	ጨፈቃ
slush	t͡ʃʼfq	ጨፈቃ
morass	t͡ʃʼfq	ጨፈቃ
scion	t͡ʃʼld	ጫለዳ
leader	t͡ʃʼld	ጫለዳ
offshoot	t͡ʃʼld	ጫለዳ
offshoot	t͡ʃʼld	ጫሌዳ
chick	t͡ʃʼqʰʷt	ጫቚት
hale	t͡ʃʼtʼl	ጫጠለ
piece	t͡ʃʼlf	ጭላፍ
scoop	t͡ʃʼlf	ጭልፋ
tablespoon	t͡ʃʼlf	ጭልፋ
ladle	t͡ʃʼlf	ጭልፋ
crucible	t͡ʃʼlf	ጭልፎ
beard	t͡ʃʼħm	ጭሕሚ
bowl	t͡ʃʼħl	ጭሖሎ
basin	t͡ʃʼħl	ጭሖሎ
pike	t͡ʃʼmr	ጭማራ
harpoon	t͡ʃʼmr	ጭማራ
watchword	t͡ʃʼrħ	ጭረሖ
apostrophe	t͡ʃʼrt	ጭረት
segment	t͡ʃʼrm	ጭራም
piece	t͡ʃʼrm	ጭራም
shred	t͡ʃʼrm	ጭራም
chip	t͡ʃʼrm	ጭራም
ogre	t͡ʃʼrq	ጭራቅ
slogan	t͡ʃʼrħ	ጭርሖ
device	t͡ʃʼrħ	ጭርሖ
watchword	t͡ʃʼrħ	ጭርሖ
aperture	t͡ʃʼrt	ጭርታ
concrete	t͡ʃʼbtʼ	ጭቡጥ
grip	t͡ʃʼbtʼ	ጭባጠ
contraction	t͡ʃʼbtʼ	ጭባጠ
testimonial	t͡ʃʼbtʼ	ጭብጢ
actuality	t͡ʃʼbtʼ	ጭብጢ
fact	t͡ʃʼbtʼ	ጭብጢ
instance	t͡ʃʼbtʼ	ጭብጦ
grit	t͡ʃʼnt͡ʃʼ	ጭንጫ
atrocity	t͡ʃʼkn	ጭካነ
hoe	t͡ʃʼxʷr	ጭዃሮ
beef	t͡ʃʼwd	ጭዋዳ
muscle	t͡ʃʼwd	ጭዋዳ
sandy	t͡ʃʼʕj	ጭዓይ
ping	t͡ʃʼzt	ጭዝታ
twitter	t͡ʃʼdr	ጭደራ
chirp	t͡ʃʼt͡ʃʼt	ጭጭታ
squad	t͡ʃʼfr	ጭፍራ
fleet	t͡ʃʼfr	ጭፍራ
crew	t͡ʃʼfr	ጭፍራ
coterie	t͡ʃʼfr	ጭፍራ
troupe	t͡ʃʼfr	ጭፍራ
platoon	t͡ʃʼfr	ጭፍራ
horde	t͡ʃʼfr	ጭፍራ
gang	t͡ʃʼfr	ጭፍራ
crowd	t͡ʃʼfr	ጭፍራ
pontiff	pʼpʼs	ጳጳስ
prelate	pʼpʼs	ጳጳስ
weed	t͡sʼhj	ጸሃየ
soot	t͡sʼll	ጸለላ
soot	t͡sʼll	ጸለሎ
steal	t͡sʼlqʰʷ	ጸለቘ
affect	t͡sʼlw	ጸለወ
invocation	t͡sʼlj	ጸለየ
prayer	t͡sʼlt	ጸሉት
sable	t͡sʼlm	ጸሊም
night	t͡sʼlm	ጸላም
enemy	t͡sʼlʔ	ጸላኢ
factor	t͡sʼlw	ጸላዊ
influence	t͡sʼlw	ጸላዊ
hate	t͡sʼlʔ	ጸልአ
prayer	t͡sʼlt	ጸሎት
petition	t͡sʼlt	ጸሎት
rosary	t͡sʼlt	ጸሎት
secretary	t͡sʼħf	ጸሐፊ
employee	t͡sʼħf	ጸሐፊ
sun	t͡sʼħj	ጸሓይ
sol	t͡sʼħj	ጸሓይ
autograph	t͡sʼħf	ጸሓፈ
writer	t͡sʼħf	ጸሓፊ
secretary	t͡sʼħf	ጸሓፊ
scribe	t͡sʼħf	ጸሓፊ
brew	t͡sʼmqʰʷ	ጸመቘ
filter	t͡sʼmqʰʷ	ጸመቘ
press	t͡sʼmqʰʷ	ጸመቘ
screw	t͡sʼmqʰʷ	ጸመቘ
wally	t͡sʼmm	ጸማም
fleece	t͡sʼmr	ጸምሪ
fur	t͡sʼmr	ጸምሪ
wool	t͡sʼmr	ጸምሪ
extract	t͡sʼmqʰʷ	ጸሞቘ
chisel	t͡sʼrb	ጸረበ
file	t͡sʼrb	ጸረበ
brush	t͡sʼrɡ	ጸረገ
radius	t͡sʼrɡ	ጸርጊ
ray	t͡sʼrɡ	ጸርጊ
radiation	t͡sʼrɡ	ጸርጊ
indignity	t͡sʼrf	ጸርፊ
affront	t͡sʼrf	ጸርፊ
push	t͡sʼqʰtʼ	ጸቐጠ
touch	t͡sʼqʰtʼ	ጸቐጠ
press	t͡sʼqʰtʼ	ጸቐጠ
oppressor	t͡sʼqʰtʼ	ጸቓጢ
pressure	t͡sʼqʰtʼ	ጸቕጢ
stress	t͡sʼqʰtʼ	ጸቕጢ
trouble	t͡sʼbb	ጸበባ
soup	t͡sʼbħ	ጸብሒ
stew	t͡sʼbħ	ጸብሒ
mud	t͡sʼbr	ጸብሪ
wait	t͡sʼnħ	ጸንሐ
stay	t͡sʼnħ	ጸንሐ
support	t͡sʼwr	ጸወረ
sport	t͡sʼwt	ጸወታ
game	t͡sʼwt	ጸወታ
fun	t͡sʼwt	ጸወታ
performance	t͡sʼwt	ጸወታ
invocation	t͡sʼwʕ	ጸወዐ
trestle	t͡sʼwr	ጸዋሪ
supporter	t͡sʼwr	ጸዋሪ
element	t͡sʼwr	ጸዋሪ
armature	t͡sʼwr	ጸዋሪ
fun	t͡sʼwt	ጸውታ
call	t͡sʼwʕ	ጸውዐ
source	t͡sʼʕt	ጸዓት
effort	t͡sʼʕt	ጸዓት
pack	t͡sʼʕn	ጸዓነ
burden	t͡sʼʕn	ጸዓነ
load	t͡sʼʕn	ጸዓነ
freight	t͡sʼʕn	ጸዓነ
produce	t͡sʼʕd	ጸዓደ
blur	t͡sʼjqʰ	ጸየቐ
blemish	t͡sʼjqʰ	ጸየቐ
smudge	t͡sʼjqʰ	ጸየቐ
lisp	t͡sʼjf	ጸየፈ
vice	t͡sʼjq	ጸይቂ
vise	t͡sʼjq	ጸይቂ
assumption	t͡sʼdqʰ	ጸደቐ
ray	t͡sʼdl	ጸዳል
cliff	t͡sʼdf	ጸድፊ
difficulty	t͡sʼɡm	ጸገም
problem	t͡sʼɡm	ጸገም
complication	t͡sʼɡm	ጸገም
handicap	t͡sʼɡm	ጸገም
need	t͡sʼɡm	ጸገም
repair	t͡sʼɡn	ጸገነ
dole	t͡sʼɡw	ጸገወ
protection	t͡sʼɡʕ	ጸገዒ
hair	t͡sʼɡr	ጸጉሪ
left	t͡sʼɡm	ጸጋም
tutelage	t͡sʼɡʕ	ጸግዒ
brick	t͡sʼɡʕ	ጸግዒ
anchor	t͡sʼɡʕ	ጸግዒ
pigment	t͡sʼɡʷr	ጸጓር
spread	t͡sʼtʼħ	ጸጥሐ
peace	t͡sʼtʼt	ጸጥታ
silence	t͡sʼtʼt	ጸጥታ
still	t͡sʼtʼt	ጸጥታ
grit	t͡sʼt͡sʼr	ጸጸር
shingle	t͡sʼt͡sʼr	ጸጸር
pebble	t͡sʼt͡sʼr	ጸጸር
compunction	t͡sʼt͡sʼt	ጸጸት
contrition	t͡sʼt͡sʼt	ጸጸት
flat	t͡sʼfħ	ጸፊሕ
level	t͡sʼfħ	ጸፊሕ
spawn	t͡sʼfj	ጸፋዪ
slap	t͡sʼfʕ	ጸፍዐ
paw	t͡sʼfʕ	ጸፍዐ
whack	t͡sʼfʕ	ጸፍዐ
strike	t͡sʼfʕ	ጸፍዐ
flap	t͡sʼfʕ	ጸፍዐ
gust	t͡sʼfʕ	ጸፍዒ
squeak	t͡sʼt͡sʼt	ጺጽታ
hiss	t͡sʼt͡sʼt	ጺጽታ
enemy	t͡sʼlʔ	ጻላኢ
pot	t͡sʼħl	ጻሕሊ
exodus	t͡sʼʔt	ጻኦት
effort	t͡sʼʕr	ጻዕሪ
industry	t͡sʼʕr	ጻዕሪ
pain	t͡sʼʕr	ጻዕሪ
intensity	t͡sʼʕq	ጻዕቂ
congestion	t͡sʼʕq	ጻዕቂ
density	t͡sʼʕq	ጻዕቂ
white	t͡sʼʕd	ጻዕዳ
ivory	t͡sʼʕd	ጻዕዳ
saint	t͡sʼdqʰ	ጻድቕ
freak	t͡sʼll	ጽሉል
lunatic	t͡sʼll	ጽሉል
maniac	t͡sʼll	ጽሉል
anathema	t͡sʼlʔ	ጽሉእ
scum	t͡sʼll	ጽላ'ል
mania	t͡sʼll	ጽላለ
hysteria	t͡sʼll	ጽላለ
madness	t͡sʼll	ጽላለ
tutelage	t͡sʼll	ጽላል
awning	t͡sʼll	ጽላል
shade	t͡sʼll	ጽላል
table	t͡sʼlt	ጽላት
tablet	t͡sʼlt	ጽላት
slab	t͡sʼlt	ጽላት
sector	t͡sʼlt	ጽላት
animosity	t͡sʼlʔ	ጽልኢ
hate	t͡sʼlʔ	ጽልኢ
revulsion	t͡sʼlʔ	ጽልኢ
antipathy	t͡sʼlʔ	ጽልኢ
animus	t͡sʼlʔ	ጽልኢ
venom	t͡sʼlʔ	ጽልኢ
influence	t͡sʼlw	ጽልዋ
incidence	t͡sʼlw	ጽልዋ
radiation	t͡sʼlw	ጽልዋ
impact	t͡sʼlw	ጽልዋ
fax	t͡sʼħf	ጽሑፍ
novel	t͡sʼħf	ጽሑፍ
script	t͡sʼħf	ጽሑፍ
writing	t͡sʼħf	ጽሑፍ
spruce	t͡sʼħd	ጽሕዲ
fir	t͡sʼħd	ጽሕዲ
pine	t͡sʼħd	ጽሕዲ
fibre	t͡sʼħɡ	ጽሕጊ
synthesis	t͡sʼmr	ጽሙር
secret	t͡sʼmw	ጽሙው
complex	t͡sʼmr	ጽማረ
synthesis	t͡sʼmr	ጽማረ
synthesis	t͡sʼmr	ጽማሬ
epitome	t͡sʼmqʰʷ	ጽማቚ
juice	t͡sʼmqʰʷ	ጽማቝ
resume	t͡sʼmqʰʷ	ጽማቝ
outline	t͡sʼmqʰʷ	ጽማቝ
synopsis	t͡sʼmqʰʷ	ጽማቝ
summary	t͡sʼmqʰʷ	ጽማቝ
solitude	t͡sʼmw	ጽምዋ
loneliness	t͡sʼmw	ጽምዋ
twin	t͡sʼmd	ጽምዲ
pair	t͡sʼmd	ጽምዲ
couple	t͡sʼmd	ጽምዲ
distillation	t͡sʼrt	ጽረ'ት
star	t͡sʼrr	ጽሩራ
sweet	t͡sʼrj	ጽሩይ
liquid	t͡sʼrj	ጽሩይ
sapphire	t͡sʼrj	ጽሩይ
trim	t͡sʼrj	ጽሩይ
essence	t͡sʼrr	ጽራ'ር
chip	t͡sʼrb	ጽራብ
purification	t͡sʼrt	ጽሬት
enemy	t͡sʼrd	ጽርዲ
clearance	t͡sʼrɡ	ጽርጋ
tidiness	t͡sʼrt	ጽሮት
tolerance	t͡sʼrt	ጽሮት
cleanliness	t͡sʼrt	ጽሮት
sleeper	t͡sʼbqʰ	ጽቡቕ
beauty	t͡sʼbqʰ	ጽባቐ
stable	t͡sʼnʕ	ጽኑዕ
close	t͡sʼnʕ	ጽኑዕ
sound	t͡sʼnʕ	ጽኑዕ
extermination	t͡sʼnt	ጽንታ
annihilation	t͡sʼnt	ጽንታ
cape	t͡sʼnf	ጽንፊ
scowl	t͡sʼwɡ	ጽወጋ
chalice	t͡sʼwʔ	ጽዋእ
font	t͡sʼwʔ	ጽዋእ
energy	t͡sʼʕt	ጽዓት
corn	t͡sʼʕt	ጽዖት
delinquency	t͡sʼjqʰ	ጽየቓ
foul	t͡sʼjʔ	ጽዩእ
offensive	t͡sʼjf	ጽዩፍ
foul	t͡sʼjf	ጽዩፍ
blur	t͡sʼjqʰ	ጽያቕ
impropriety	t͡sʼjf	ጽያፍ
obscenity	t͡sʼjf	ጽያፍ
profanity	t͡sʼjf	ጽያፍ
dirt	t͡sʼjf	ጽያፍ
spring	t͡sʼdj	ጽድያ
rehabilitation	t͡sʼɡn	ጽገና
dependence	t͡sʼɡʕ	ጽጋዕ
mumps	t͡sʼɡʕ	ጽጌዕ
pearl	t͡sʼt͡sʼj	ጽጻይ
trim	t͡sʼft	ጽፈት
nice	t͡sʼff	ጽፉፍ
trim	t͡sʼff	ጽፉፍ
plane	t͡sʼfħ	ጽፍሒ
level	t͡sʼfħ	ጽፍሒ
nail	t͡sʼfr	ጽፍሪ
activity	t͡sʼtw	ጾታዊ
start	flm	ፈለመ
detection	flɡ	ፈለገ
footprint	flɡ	ፈለግ
tributary	flɡ	ፈለግ
river	flɡ	ፈለግ
bromide	fltʼ	ፈሊጥ
emigrant	fls	ፈላ'ሲ
beginner	flm	ፈላሚ
pioneer	flm	ፈላሚ
settler	fls	ፈላሲ
expert	fltʼ	ፈላጥ
practitioner	fltʼ	ፈላጥ
seedling	fls	ፈልሲ
hole	fħr	ፈሓረ
burrow	fħr	ፈሓረ
twist	fħs	ፈሓሰ
collapse	frs	ፈረሰ
cob	frs	ፈረስ
horse	frs	ፈረስ
ferret	frt	ፈረት
seed	frj	ፈረየ
sentence	frd	ፈረደ
try	frd	ፈረደ
funk	frħ	ፈራሕ
yellow	frħ	ፈራሕ
axis	frqʰ	ፈራቒ
progenitor	frj	ፈራዪ
macro	frj	ፈራዪ
judge	frd	ፈራዲ
arbitrator	frd	ፈራዲ
arbiter	frd	ፈራዲ
court	frd	ፈራዶ
remainder	frd	ፈራዶ
jury	frd	ፈራዶ
judiciary	frd	ፈራዶ
fear	frh	ፈርሀ
cow	frh	ፈርሀ
quail	frh	ፈርሀ
pulp	frs	ፈርሲ
gene	frʕ	ፈርዒ
weather	fsm	ፈሰመ
issue	fss	ፈሰሰ
flow	fss	ፈሰሰ
tribute	fss	ፈሰስ
juice	fss	ፈሳሲ
pump	fss	ፈሳሲ
fluid	fss	ፈሳሲ
liquid	fss	ፈሳሲ
valve	fss	ፈሳሲ
outlet	fss	ፈሳሲ
flop	fʃl	ፈሸለ
barrel	fʃt	ፈሸታ
police	fqʰj	ፈቐየ
patrol	fqʰj	ፈቐየ
consent	fqʰd	ፈቐደ
permit	fqʰd	ፈቐደ
grant	fqʰd	ፈቐደ
picket	fqʰj	ፈቓዪ
attempt	ftn	ፈተ'ነ
essay	ftn	ፈተ'ነ
try	ftn	ፈተ'ነ
experiment	ftn	ፈተ'ነ
spin	ftl	ፈተለ
overhaul	ftʃ	ፈተሸ
search	ftʃ	ፈተሸ
proof	ftn	ፈተነ
attempt	ftn	ፈተነ
try	ftn	ፈተነ
venture	ftn	ፈተነ
quiz	ftn	ፈተነ
trial	ftn	ፈተነ
examination	ftn	ፈተና
test	ftn	ፈተና
exam	ftn	ፈተና
experiment	ftn	ፈተና
like	ftw	ፈተወ
detective	ftʃ	ፈታሺ
examiner	ftn	ፈታኒ
lover	ftw	ፈታዊ
friend	ftw	ፈታዊ
pro	ftw	ፈታዊ
filament	ftl	ፈትሊ
strand	ftl	ፈትሊ
thread	ftl	ፈትሊ
yarn	ftl	ፈትሊ
line	ftl	ፈትሊ
cotton	ftl	ፈትሊ
divorce	ftħ	ፈትሐ
acquit	ftħ	ፈትሐ
answer	ftħ	ፈትሐ
release	ftħ	ፈትሐ
broadcast	fnw	ፈነወ
exhale	fnw	ፈነወ
broadcast	fnw	ፈነዋ
transmission	fnw	ፈነዋ
lightweight	fkʷs	ፈኲስ
cure	fws	ፈወሰ
healer	fws	ፈዋሲ
physician	fws	ፈዋሲ
potion	fws	ፈውሲ
medication	fws	ፈውሲ
drug	fws	ፈውሲ
panacea	fws	ፈውሲ
dosage	fws	ፈውሲ
remedy	fws	ፈውሲ
glaze	fzz	ፈዘዘ
dope	fzz	ፈዛዝ
alphabet	fdl	ፈደል
use	fdj	ፈደየ
rob	fɡr	ፈገረ
steal	fɡr	ፈገረ
burglar	fɡr	ፈገር
fiction	ftʼr	ፈጠራ
myth	ftʼr	ፈጠራ
generation	ftʼr	ፈጠራ
fabrication	ftʼr	ፈጠራ
speed	ftʼn	ፈጠነ
creator	ftʼr	ፈጣሪ
maker	ftʼr	ፈጣሪ
author	ftʼr	ፈጣሪ
lightning	ftʼn	ፈጣን
swift	ftʼn	ፈጣን
finish	ft͡sʼm	ፈጸመ
acne	ft͡sʼɡ	ፈጸጋ
agent	ft͡sʼm	ፈጻሚ
split	ft͡sʼħ	ፈጽሐ
bay	frd	ፉርዳ
bean	fxl	ፉኾሊ
bluster	fft	ፉፍታ
fillet	flt	ፊለቶ
movie	flm	ፊልም
film	flm	ፊልም
epilogue	flm	ፊልም
excerpt	flm	ፊልም
boom	fħt	ፊሕታ
bladder	fħɲ	ፊሕኛ
signature	frm	ፊርማ
barrel	fst	ፊስቶ
sob	fqʰt	ፊቕታ
letter	fdl	ፊደል
scythe	flʃ	ፋልሺ
blast	fmt	ፋምታ
passover	fsk	ፋሲካ
passover	fsɡ	ፋስጋ
lamp	fns	ፋኑስ
cleavage	fntʼ	ፋንጣ
ace	fntʼ	ፋንጣ
avenue	fntʼ	ፋንጣ
skein	fʔm	ፋእሚ
fauna	fwn	ፋውና
fruit	fjd	ፋይዳ
fife	fjf	ፋይፍ
green beans	fd͡ʒl	ፋጆሊ
bean	fd͡ʒl	ፋጆሊ
hiss	ft͡sʼj	ፋጸየ
gala	fst	ፌስታ
festival	fst	ፌስታ
exception	flj	ፍሉይ
individual	flj	ፍሉይ
society	flj	ፍሉይ
arrow	flt͡sʼ	ፍላጻ
weasel	fħr	ፍሒራ
groove	fħr	ፍሓ'ር
burrow	fħr	ፍሓ'ር
string	fħs	ፍሕሶ
twine	fħs	ፍሕሶ
bladder	fħɲ	ፍሕኛ
fruit	frt	ፍሩታ
wreckage	frs	ፍራስ
trepidation	frħ	ፍርሒ
horror	frħ	ፍርሒ
semi	frq	ፍርቂ
judgment	frd	ፍርዲ
award	frd	ፍርዲ
trial	frd	ፍርዲ
effusion	fst	ፍሰ'ት
influx	fst	ፍሰት
sewage	fss	ፍሳስ
joy	fsh	ፍስሃ
exhilaration	fsh	ፍስሃ
elation	fsh	ፍስሃ
butt	fst	ፍስቶ
tank	fst	ፍስቶ
barrel	fst	ፍስቶ
pet	fqʰr	ፍቑር
entree	fqʰd	ፍቓድ
approval	fqʰd	ፍቓድ
consent	fqʰd	ፍቓድ
volition	fqʰd	ፍቓድ
authorization	fqʰd	ፍቓድ
permission	fqʰd	ፍቓድ
worship	fqʰr	ፍቕሪ
love	fqʰr	ፍቕሪ
guard	fqʰj	ፍቕያ
outpost	fqʰj	ፍቕያ
patrol	fqʰj	ፍቕያ
verse	fqʰd	ፍቕዲ
count	fqʰd	ፍቕዲ
probe	ftʃ	ፍተሻ
loose	ftħ	ፍቱሕ
peach	ftw	ፍቱው
dear	ftw	ፍቱው
angel	ftw	ፍቱው
solution	ftħ	ፍታሕ
answer	ftħ	ፍታሕ
equity	ftħ	ፍትሒ
justice	ftħ	ፍትሒ
divorce	ftħ	ፍትሕ
volition	ftt	ፍቶት
morale	fnn	ፍናን
triumph	fnn	ፍናን
elation	fnn	ፍናን
medication	fws	ፍወሳ
therapy	fws	ፍወሳ
treatment	fws	ፍወሳ
trance	fzt	ፍዘት
stupor	fzt	ፍዘት
sip	fjt	ፍያቶ
flower	fjr	ፍዮሪ
theft	fɡr	ፍግሪ
creature	ftʼr	ፍጡር
whole	ft͡sʼm	ፍጹም
transaction	ft͡sʼm	ፍጻመ
incident	ft͡sʼm	ፍጻመ
episode	ft͡sʼm	ፍጻመ
coverage	ft͡sʼm	ፍጻመ
event	ft͡sʼm	ፍጻመ
scene	ft͡sʼm	ፍጻሜ
occurrence	ft͡sʼm	ፍጻሜ
affair	ft͡sʼm	ፍጻሜ
achievement	ft͡sʼm	ፍጻሜ
sheet paper	flj	ፎልዮ
leaf	flj	ፎልዮ
oven	frn	ፎርኖ
lining	fdr	ፎደራ
pedal	pdl	ፐዳለ
poodle	pdl	ፑድል
ph	pʔt͡ʃ	ፒኤች
plaza	pjs	ፒያሳ
piano	pjn	ፒያኖ
aspen	pjp	ፒዮፖ
psi	ptʔ	ፓ.ት.ኢ
pump	pmp	ፓምፓ
piston	pmp	ፓምፓ
party	prt	ፓርቲ
parody	prd	ፓሮዲ
pagoda	pɡd	ፓጎዳ
polity	plt	ፕሉቶ
pluto	plt	ፕሉቶ
copper	pls	ፖሊስ
police	pls	ፖሊስ
cop	pls	ፖሊስ
phalanx	pls	ፖሊስ
bobby	pls	ፖሊስ
pomp	pmp	ፖምፓ
pasta	pst	ፖሲት
pastry	pst	ፖሲት
potash	ptʃ	ፖታሽ
poker	pkr	ፖከር
