Aegean Sea	ኤጅያዊ ባሕርን	
Africa	ኣፍሪቃ	ʔafɨriqa
African Union	ኣፍሪቃዊ ሕብረት; ሕብረት ኣፍሪካ	ʔafɨriqawi ħɨbɨrət
America	ኣሜሪካን	ʔamerika
Amharic (language)	ኣምሓረኛ ፊደል	
Amsterdam	ኣምስተርዳም	ʔamɨsɨtərɨdam
Assab	ዓሰብ	
Associated Press	ኣሶሼትድ ፕረስ	ʔasoʃetɨd pɨrəs
Bangladesh	ባንግላዴሽ	banɨɡɨladeʃ
Bani Walid	በኒ ወሊድ	bəni wəlid
Belgium	በልጁም	bəlɨd͡ʒum
Britain	ብሪጣንያ	bɨritʼanɨja
British Red Cross	ቀይሕ መስቀል እንግሊዝ	qəjɨħ məsɨqəl ʔɨnɨɡɨliz
Budapest	ቡዳፔሽት	budapeʃɨt
Calais	ካሌ	kale
Danish (people)	ደንማርካዊ	dənɨmarɨkawi
Djibouti	ጂቡቲ	
DMHT	ዴምህት	
Donald Tusk	ዶናልድ ታስክ	donalɨd tasɨk
Eritrea	ኤርትራ	ʔerɨtɨra
Ethiopia	ኢትዮጵያ	ʔitɨjopʼɨja
Europe	ኣውሮጳ ; ኤውሮጳ	ʔewɨropʼa
European Parliament	ፓርላማ ኤውሮጳዊ ሕብረት	parɨlama ʔewɨropʼawi ħɨbɨrət
European Union; EU	ኤውሮጳዊ ሕብረት	ʔewɨropʼawi ħɨbɨrət
Forto	ፎርቶ	
France	ፈረንሳ	fərənɨs
Gaza	ቃዛን	qazan
Gebru (name)	ገብሩ	
Germany	ጀርመን	d͡ʒərɨmən
Germay (name)	ግርማይ	
Greece	ግሪኽን	ɡɨrixɨn
Harwich	ሃርዊች	harɨwit͡ʃ
Horn of Africa	ቀርኒ ኣፍሪቃ	qərɨni ʔafɨriqa
Hull	ሃል	hal
Humora (city)	ከተማ ሑመራ	
Hungary	ሃንጋሪ	hanɨɡari
IGAD	ኢጋድ	ʔiɡad
International Organization for Migration	ኣህጉራዊ ማሕበር ስደተኛታት	ʔahɨɡurawi maħɨbər sɨdətəɲatat
Isaias (Afwerki – president of Eritrea)	ኢሰያስ	
Islamic State; ISIS	ዳዒሽ	daʕiʃ
Israeli (people)	እስራኤል	ʔɨsɨraʔel
Italy	ልያንን	ʼɨlɨjanɨn
Joseph Muscat	ጆዘፍ ሙስካት	d͡ʒozəf musɨkat
Kenya	ኬንያ	kenɨja
Khoms	ኹምስ	xumɨs
Kiros	ኪሮስ	kiros
Libya	ሊብያ	libɨja
Malta	ማልታ	malɨta
Massawa	ምጽዋዕ	mɨt͡sʼɨwaʕ
Mediterranean Sea	ማእከላይ ባሕሪ	maʔɨkəlaj baħɨri
Middle East	ማእከላይ ምብራቕ	maʔɨkəlaj mɨbɨraqʰ
Milan	ሚላኖ	milano
Morocco	ሞሮኮ	moroko
Naizgi Kiflu	ናይዝጊ ክፍሉ	
Netherlands	ሆላንድን	holanɨdɨn
Newcastle	ኒውካስል	niwɨkasɨl
Nigeria	ናይጀርያ	najɨd͡ʒərɨja
North America	ሰሜን ኣሜሪካን	səmen ʔamerikan
Palestinian (people)	ፍሊስጤማዊያን	fɨlisɨtʼemawijan
Red Crescent	ቀይሕ ወርሒ	qəjɨħ wərɨħi
Rio de Janeiro	ሪሆ ቴ ተኔሂሮ	
Rotterdam	ሮተርዳም	rotərɨdam
Sabratha	ሳብራታ	sabɨrata
Sahara	ሳሃራ	sahara
Serbia	ሰርቢያ	sərɨbija
Shira	ከተማ ሽረ	
Sicily	ሲቺልያ	sit͡ʃilɨja
Sinai Desert	ሲናይ	
Somalia	ሶማሊያ	
Spain	ስጳኛን; ስጳኛን	sɨpʼaɲa
Straight of Sicily	መጻብቦ ሲቺልያ	mət͡sʼabɨbo sit͡ʃilɨja
Strasbourg	ስትራስቦርግ	sɨtɨrasɨborɨɡ
Sudan	ሱዳን	
Tajoura	ታጁራ	tad͡ʒura
Teseney	ተሰነይ 	təsənəj
Thomas de Maiziere	ቶማስ ደ መይዚራ	tomas də məjɨzira
Tigrayans (people)	ተጋሩ	
Tigrinya; Tigrigna	ትግርኛ	tɪˈɡriːnjə
Tripoli	ትሪፖሊ	tɨripoli
Tunisia	ቱኒዢያ 	
Turkey	ቱርኪን	turɨkin
Uganda	ኡጋንዳ	ʔuɡanɨda
UNICEF	ጸብጻብ ዩኒሴፍ	junisef
United Kingdom; UK	መንግስቲ እንግሊዝ	mənɨɡɨsɨti ʔɨnɨɡɨliz
Valetta	ቫሌታ	valeta
Viktor Orbàn	ቪክቶር ኦርባን	vikɨtor ʔorɨban
Welkait (city)	ወልቃይት	
West Bank	ዌስት ባንክ	wesɨt banɨk
Western Balkans	ምዕራባውያን ሃገራት ባልካን	mɨʕɨrabawɨjan haɡərat balɨkan
Zawiya	ዛዊያ	zawija
