Tigrean	ትግራዋይ	tɨɡɨrawajɨ	adj
Tigrean	ትግራወይቲ	tɨɡɨrawəjɨti	adj
Tigray	ትግራይ	tɨɡɨraj	noun
Nigeria	ናይጀርያ	najɨd͡ʒərɨja	noun
democracy	ዴሞክራሲ	demokɨrasi	noun
sheep	በግዕ	bəɡɨʕɨ	noun
thief	ጕሒላ	ጕħila	noun
feeder	ቀላቢ	qəlabi	noun
infant	ሕጻን	ħɨt͡sʼanɨ	noun
star	ኮኸብ	koxəb	noun
exist	ኣሎ	ʔalo	verb
and	ውን	wɨn	conj
and	ከኣ	kəʔa	conj
but	እምበር	ʔɨmɨbər	conj
therefore	እምበአር	ʔɨmɨbəʔər	conj
although	እኳ	ʔɨkwa	conj
Eritrean	ኤርትራዊ	ʔerɨtɨrawi	noun
Nakfa	ናቕፋ	naqʰɨfa	noun
migrants	ስደተኛታት	sɨdətəɲatat 	noun
children	ቘልዑ	qʰʷəlɨʕu	noun
men	ሰብኡት	səbɨʔut	noun
international	ኣህጕራዊ	ʔahɨɡʷɨrawi	adj
regional	ዞናዊ	zonawi	adj
minister	ምንስትር	mɨnɨsɨtɨr	noun
citizens	ሃገራውያን	haɡərawɨjan	noun
return	ተመልሰ	təməlɨsə	verb
president	ፕረዚደንት	pɨrəzidənɨt	noun
