don't shoot	ከይትትኲስ
move	ኣልግስ
follow me	ተኸተለኒ
turn around	ተጠወ
give me	ሃባ
keep away	ረሓቕ
let us pass	ኣሕልፈና
don't be frightened	ኣይትፍራሕ
go	ኪድ
open	ክፈት
close	ዕጾ
beware	ተጠንቀቕ
bring me	ኣምጽኣለይ
distribute	ዘርግሕ
fill	መልኤ
lift	ኣልዓለ
pour into	ገልበጠ
put	ኣቐመጠ
take	ወሰደ
load	ጸዓነ
unload	ኣራገፈ
help me	ሓግዘኒ
show me	ኣርእየኒ
tell me	ንገረኒ
please	በጃኻ
thank you	የቐንየለይ
ok	ሕራይ
yes	እወ
no	ኣይኰነን
right	ቅኑዕ
wrong	ጌጋ
here	ኣብዚ
there	ኣብቲ
I want	ደልየ
danger	ሓደጋ
who	መን
what	እንታይ
when	መዓስ
where	ኣበይ
why	ስለምንታይ
how	ከመይ
I am	እየ
you are	ኢኻ
we are	ኢና
they are	እዮም
hello	ሰላም
do you understand	ይርድአካዶ
I don't understand	ኣይርድአንን
how many	ክንደይ
repeat it	ድገሞ
plus	ዝተደመሮ
minus	ዝጐደሎ
more	ዝበዝሔ
less	ዝወሓደ
approximately	ኣስታት
first	ቀዳማይ
second	ካልኣይ
third	ሳልሳይ
Sunday	ሰንበት
Monday	ሰኑይ
Tuesday	ሰሉስ
Wednesday	ረቡዕ
Thursday	ሓሙስ
Friday	ዓርቢ
Saturday	ቀዳም
yesterday	ትማሊ
today	ሎሚ
tomorrow	ጽባሕ
day	መዓልቲ
night	ለይቲ
week	ሰሙን
month	ወርሒ
year	ዓመት
second	ሰከንድ
minute	ደቒቓ
hour	ሰዓት
morning	ንግሆ
evening	ምሸት
afternoon	ድሕሪ-ቀትሪ
midnight	ፍርቂ-ለይቲ
now	ሕጂ
later	ደሓር
above	ብልዕሊ
after	ድሕሪ
back	ድሕሪት
before	ቅድሚ
coordinates	መጋጥሞታት
degrees	ዲግሪ
down	ታሕቲ
east	ምብራቕ
far	ርሑቕ
longitude	ሎንጊትዩድ
left	ጸጋም
latitude	ላቲትዩድ
near	ጥቓ
north	ሰሜን
northeast	ሰሜን-ምብራቕ
northwest	ሰሜን-ምዕራብ
right	የማን
south	ደቡብ
southeast	ደቡብ-ምብራቕ
southwest	ደቡብ-ምዕራብ
up	ላዕሊ
west	ምዕራብ
beach	ገምገም-ባሕሪ
border	ዶብ
bridge	ድልድል
camp	መዓስከር
forest	ዱር
harbor	መርሳ
hill	ኰረብታ
house	ገዛ
lake	ቀላይ
meadow	ሸኻ
mountain	እምባ
ocean	ውቅያኖሰ
path	መንገዲ
paved road	ጽርግያ
place	ቦታ
position	መቓምጦ
river	ሩባ
road	ጐደና
sea	ባሕሪ
square	ኣደባባይ
tree	ኦም
valley	ሩባሩባ
village	ዓዲ
where	ኣበይ
black	ጸሊም
blue	ሰማያዊ
brown	ቡናዊ
gray	ሓሙኽሸታይ
green	ሓምላይ
orange	ብርቱኻናዊ
purple	ቂሔ-ሰማያዊ
red	ቀይሕ
white	ጻዕዳ
yellow	ብጫ
big	ዓብዪ
deep	ዓሚቝ
long	ነዊሕ
narrow	ጸቢብ
short	ሓጺር
short	ሓጺር
small, little	ንእሽቶይ
tall	ነዊሕ
thick	ረጕድ
thin	ረቒቕ
wide	ጐዳን
round	ከቢብ
square	ትርብዒት
triangular	ስሉስ-ኲርናዕ
fresh	ሓድሽ
salty	ጨዋም
sour	መጺጽ
spicy	መሪር
sweet	ምቁር
bad	ሕማቕ
clean	ጽሩይ
dark	ጸልማት
difficult	ጽንኩር
dirty	ረሳሕ
dry	ንቑጽ
easy	ቀሊል
empty	ባዶ
expensive	ክቡር
fast	ቅልጡፍ
foreign	ወጻኢ
full	ምሉእ
good	ጽቡቕ
hard	ተሪር
heavy	ከቢድ
inexpensive	ሕሱር
light	ብርሃን
light	ፈኵስ
local	ውሽጣዊ
new	ሓድሽ
old	ብላይ
old	ሽማግለ
powerful	ሓያል
quiet	ስቕታ
right	ቅኑዕ
slow	ዝሕቱል
soft	ልምሉም
very	ብጣዕሚ
weak	ድኹም
wet	ትርኩስ
wrong	ጌጋ
young	ንኡስ
few	ውሑድ
many	ብዙሓት
part	ክፋል
some	ብመጠኑ
whole	ምሉእ
emergency	ኲነተ-ሓደጋ
food	ምግቢ
can	ታኒካ
cup	ኩባያ
fork	ፋርኬታ
knife	ካራ
plate	ብያቲ
spoon	ማንካ
beans	ዓተር
beer	ቢራ
bread	ባኒ
butter	ጠስሚ
cheese	ጅብና
coffee	ቡን
fish	ዓሳ
flour	ሓርጭ
fruit	ፍሩታ
meat	ስጋ
milk	ጸባ
oil	ዘይቲ
potatoes	ድንሽ
rice	ሩዝ
salt	ጨው
soup	መረቕ
sugar	ሽኮር
tea	ቀጠፍ
vegetables	ኣሕምልቲ
water	ማይ
wine	ነቢት
drink	ስተ
eat	ብላዕ
gasoline	ጋዞሊን
oil	ዘይቲ
diesel	ዲዘል
liters	ሊትሮ
400-cycle	400-ሳይክል
3-phase	3-ፈይዝ
115-volt	115-ቮልት
antibiotics	ኣንቲባዮቲክስ
bandage	ፋሻ
blood	ደም
burn	ንዳድ
clean	ጽሩይ
dead	ምዉት
doctor	ዶክተር
fever	ረስኒ
hospital	ኣስቢዳለ
infection	ረኽሲ
injured	ህሱይ
malnutrition	ጕድለት-ምግቢ
medicine	መድሓኒት
nurse	ኣላዪት-ሕሙማት
poison	መርዚ
sick	ሕሙም
vitamins	ቪታሚናት
wound	መውጋእቲ
abdomen	ከብዲ
ankle	ዓካር-ዓካሪቶ
arm	ቅልጽም
bone	ዓጽሚ
brain	ሓንጐል
chest	ኣፍ-ልቢ
ear	እዝኒ
elbow	ብርኪ-ኢድ
eyes	ኣዕይንቲ
face	ገጽ
finger	ኣጻብዕ
foot	እግሪ
hair	ጸጒሪ
hand	ኢድ
head	ርእሲ
heart	ልቢ
kidney	ኲሊት
knee	ብርኪ
leg	እግሪ
lips	ከናፍር
liver	ጸላም-ከብዲ
lungs	ሳንቡእ
mouth	ኣፍ
neck	ክሳድ
nose	ኣፍንጫ
pelvis	ጎሎ
ribs	መሰንገለ
shoulder	መንኩብ
skull	ሽክና-ርእሲ
spine	ዓንዲ-ሕቘ
stomach	ከብዲ
stomach	ከስዔ
teeth	ኣስናን
toe	ኣጻብዕ-እግሪ
tongue	መልሓስ
wrist	ጐንቦ-ኢድ
general	ጀነራል
admiral	ኣድሚራል
colonel	ኮሎነል
commander	ኮማንደር
major	መጀር
captain	ካፒተን
lieutenant	ትልንቲ
senior sergeant	ሓለቓ-ሰርገንቲ
soldier	ወተሃደር
airman	መራሕ-ነፋሪት
seaman	ባሕረኛ
marine	ማሪን
army	ሓይሊ-ምድሪ
marines	ማሪን
navy	ነቪ
commander	ኮማንደር
dentist	ሓኪም-ስኒ
doctor	ዶከተር
driver	ዘዋሪ
farmer	ሓረስታይ
fisherman	ገፋፍ-ዓሳ
guard	ዋርድያ
housewife	በዓልቲ-ሓዳር
laborer	ሸቃላይ
mechanic	መካኒክ
messenger	ተለኣኣኺ
pilot	ፓይሎት
policeman	ፖሊስያ
sailor	ባሕረኛ
businessman	ነጋዳይ
shopkeeper	በዓል-ድኳን
soldier	ወተሃደር
student	ተምሃራይ
teacher	መምህር
ad values	ዝተመዛዘነ
ammunition	ተተኰስቲ
baggage	ጾር
cargo	ጽዕነት
customs	ጉምሩክ
damaged	ዝተበላሸወ
delivery	ምብጻሕ
duty	ቀረጽ
expenditures	ወጻኢ
export	ሰደድ
false	ግጉይ
form	ሰነድ-ቅጥዒ
holding	ንብረት
import	ኣታዊ
insurance	መድሕን
Tigrinya	ትግርኛ
loading	ምጽዓን
narcotics	መስሕት-ኣእምሮ
nomenclature	ስየማ
on-board	ዝተሳፈረ
owner	ዋና
passport	ፓስፖርት
permission	ፍቓድ
personnel	ሰራሕተኛታት
prohibited	ክልኩል
property	ንብረት
receipt	ቅብሊት
relics	ክቡራት-ትሕዝቶ
restricted	ሕጹር
souvenir	መዘከርታ
storage	መኽዘን
tax-free	ቀረጽ-ኣልቦ
to answer	ምምላስ
to export	ምስዳድ
transportation	ምግዕዓዝ
unloading	ምርጋፍ
value	ክብሪ
visa	ቪዛ
weapons	መሳርያታት
aunt	ኣሞ
brother	ሓው
child	ቈልዓ
children	ቈልዑ
daughter	ጓል
family	ስድራ
father	ኣቦ
grandfather	ኣቦ-ሓጎ
grandmother	እነ-ሓጎ
husband	በዓል-ቤት
man	ሰብኣይ
men	ሰብኡት
mother	ኣደ
relatives	ኣዝማድ
sister	ሓፍቲ
son	ወዲ
uncle	ሓውቦ
wife	በዓልቲ-ቤት
woman	ሰበይቲ
women	ኣንስቲ
cold	ቍሪ
dry	ንቑጽ
fog	ዕምብረ
hot	ሃሩር
humidity	ርጥበት
ice	በረድ
lightning	በርቂ
rain	ዝናብ
severe	ብርቱዕ
snow	በረድ
storm	ማዕበል
temperature	ደረጃ-ሙቐት
weather	ኲነታት-ኣየር
wet	ትርኩስ
tornado	ህቦብላ
airfield	መዓልቦ-ነፈርቲ
ammunition	ተተኰስቲ
artillery	ከቢድ-ብረት
barracks	ባራካ
base	መደበር
camp	መዓስከር
cannon	መድፍዕ
car	መኪና
commander	ኮማንደር
enemy	ጸላኢ
explosive	ነታጒ
friendly	ፈታዊ
gun	ብረት
jeep	ጂፕ
kilometer	ኪሎሜትር
knife	ካራ
leader	መራሒ
machine gun	ረሻሽ
mine	ነታጒ
missile	ሚሳይል
mortar	ሞርታር
officer	መኰንን
pistol	ሽጉጥ
plane	ነፋሪት
protection	ምክልኻል
refugee	ስደተኛ
rifle	ጠበንጃ
rocket	ተወንጫፊ
rocket launcher	መወንጨፊ
shelter	መጸግዒ
ship	መርከብ
sniper	ተኳሲ
soldier	ወተሃደር
tank	ታንኪ
tent	ድኳን
trailer	ተጐታቲት
unit	ኣሃዱ
weapons	መሳርያታት
angle	ኵርናዕ
azimuth	ኣዚሙዝ
compass	ኮምፓስ
demolition	ዕንዋ
metallic	ስርሓት-ብረት
mine	ነታጒ
non-metallic	ዘይብረታዊ
pace	ስጕሚ
tree	ኦም
tape	ሸሪጥ
yes	እወ
no	ኣይኰነን
show me	ኣርእየኒ
please	በጃኻ
thank you	የቐንየለይ
you are welcome	ገንዘብካ
is it functional	ይሰርሕዶ
please	በጃኻ
thank you	የቐንየለይ
you are welcome	ገንዘብካ
no	ኣይኰነን
show me	ኣርእየኒ
yes	እወ
don't move	ከይትንቀሳቐስ
keep very still	ኣይትነቓነቕ
push against me	ድፍአኒ
cough	ሰዓል
open	ክፈቶ
turn around	ተጠወ
come with me	ተኸተለኒ
chills	ምቊራር
cough	ምስዓል
diarrhea	ውጽኣት
fever	ረስኒ
hemorrhoids	ኦሞርድያ
infection	ረኽሲ
itching	ሳሒ
nausea	ስግድግድታ
rash	ዕንፍሩር
vomiting	ተምላስ
take by mouth	ወሓጦ
tablet	ከኒና
capsule	ከኒና
puff	በዀዅታ
spray	ምርሽራሽ
patch	ልጣፍ
drop	ንጣብ
suppository	ተረኳዒ-ፈውሲ
today	ሎሚ
now	ሕጂ
tomorrow	ጽባሕ
pain	ቃንዛ
fever	ረስኒ
infection	ረኽሲ
congestion	ጥርናቐ
cough	ጕንፋዕ
do you understand	ይርደአካዶ
1	ሓደ
2	ክልተ
3	ሰለስተ
4	ኣርባዕተ
5	ሓሙሽተ
6	ሽዱሽተ
7	ሸውዓተ
8	ሸሞንተ
9	ትሽዓተ
10	ዓሰርተ
11	ዓሰርተ-ሓደ
12	ዓሰርተ-ክልተ
13	ዓሰርተ-ሰለስተ
14	ዓሰርተ-ኣርባዕተ
15	ዓሰርተ-ሓሙሽተ
16	ዓሰርተ-ሽዱሽተ
17	ዓሰርተ-ሸውዓተ
18	ዓሰርተ-ሸሞንተ
19	ዓሰርተ-ትሽዓተ
20	ዕስራ
30	ሰላሳ
40	ኣርብዓ
50	ሓምሳ
60	ስሳ
70	ሰብዓ
80	ሰማንያ
90	ተስዓ
100	ምኢቲ
500	ሓሙሽተ-ምኢቲ
1,000	ሽሕ
10,000	ዓሰርተ-ስሕ
100,000	ምኢቲ-ሽሕ
1,000,000	ሚልዮን
aids	ኤይድስ
anemia	ዋሕዲ-ደም
arthritis	ቅርጥማት
asthma	ኣዝማ
cancer	መንሽሮ
chickenpox	ፍሮማይ
diabetes	ሽኮርያ
fungus	ዕሲ'
gonorrhea	ጅግል
hepatitis	ወይቦ
influenza	ኢንፍሉወንዛ
malaria	ዓሶ
measles	ንፍዮ
mumps	ጽግዕ
plague	ፌራ
ringworm	ተውሳስ
scabies	ዓበቕ
scarlet fever	ፍሮማይ
scurvy	ሰከርቪ
smallpox	በዲዶ
syphilis	ፍንጣጣ
tapeworm infection	ሓቢ
tetanus	ተታኑስ
trichinosis	ፈገ'
typhoid fever	ቲፎ
warts	ጡብ-ኣድጊ
